lemma	tag	token	macron	source	
τλάς	a-s---mn-	ʽτλὰς	_3	
τλὰς	a-s---mn-	ʽτλὰς	_3	
ἄτᾳ	p-p---na-	ἄ	_3	
ἀβλαβείᾳ	n-s---fd-	ἀβλαβεία	_8	
ἀβουλιᾶν	n-s---fa-	ἀβουλιᾶ	_7	
ἀβουλίᾳ	n-s---fd-	ἀβουλία	_7	
ἀβουλίας	n-s---fg-	ἀβουλία	_7	
ἄγ	v2spma---	ἄγ	_1	
ἂγ	v2spma---	ἂγ	_1	
Ἀγαβάτας	n-s---mn-	Ἀγαβάτας		
ἀγαθᾶι	a-p---fn-	ἀγαθᾶι	_5	
ἀγαθᾶς	a-p---fa-	ἀγαθᾶς	_5	
ἀγαθάς	a-p---fa-	ἀγαθός	_5	
ἀγαθάς	a-p---fa-	ἀγαθός	_5	
ἀγαθὰς	a-p---fa-	ἀγαθός	_5	
ἀγαθᾶς	a-p---fa-	ἀγαθός	_5	
Ἀγαμεμνονείας	a-s---fg-	Ἀγαμεμνονεῖος		
Ἀγαμεμνονίαν	n-s---ma-	Ἀγαμεμνονία		
Ἀγαμεμνονίδας	n-s---fg-	Ἀγαμεμνονίδη		
ἀγγελίας	n-p---fa-	ἀγγελία	_7	
ἀγγελίας	n-s---fg-	ἀγγελία	_7	
ἀγγείλας	v-sapamn-	ἀγγέλλω	_7	
ἀγείρας	v-sapamn-	ἀγείρω	_6	
ἀγελαίας	a-p---fa-	ἀγελαῖος	_5	
ἀγέλας	n-p---fa-	ἀγέλη	_5	
Ἀγηνοριδᾶν	n-s---ma-	Ἀγηνοριδᾶς		
ἀγκάλας	n-p---fa-	ἀγκάλας	_6	
ἀγκάλας	n-p---fa-	ἀγκάλη	_6	
ἀγκύλας	n-p---fa-	ἀγκύλη	_6	
ἀγκύρας	n-p---fa-	ἄγκυρα	_6	
ἀγλαΐας	n-s---fg-	ἀγλαία	_6	
ἀγλαάς	a-p---fa-	ἀγλαός	_5	
ἀγλαὰς	a-p---fa-	ἀγλαός	_5	
ἁγνᾷ	a-s---fn-	ἁγνᾷ	_4	
ἁγνίσας	v-sapamn-	ἁγνίζω	_6	
ἀγνοίᾳ	n-s---fd-	ἄγνοια	_6	
ἀγνοίας	n-s---fg-	ἄγνοια	_6	
ἁγνάς	a-p---fa-	ἁγνός	_4	
ἁγνὰς	a-p---fa-	ἁγνός	_4	
ἁγνᾶς	a-s---fg-	ἁγνός	_4	
ἀγορᾷ	n-s---fd-	ἀγορά	_5	
ἀγορᾶς	n-s---fg-	ἀγορά	_5	
ἄγρας	n-s---fg-	ἄγρα	_4	
ἄγρας	n-p---fa-	ἄγρα	_4	
ἀγρευτάν	n-s---ma-	ἀγρευτάν	_7	
ἀγρευτὰν	n-s---ma-	ἀγρευτὰν	_7	
ἀγρίας	a-p---fa-	ἄγριος	_5	
ἀγρίας	a-s---fg-	ἄγριος	_5	
ἀγροβάτας	a-s---mn-	ἀγροβάτας	_8	
ἀγρωστᾶν	a-s---fa-	ἀγρωστᾶν	_7	
ἀγρώστας	a-p---fa-	ἀγρώστη	_7	
ἀγυιάς	n-p---fa-	ἀγυιά	_5	
ἀγυιάς	n-p---fa-	ἀγυιάς	_5	
ἀγυιᾶτ’	v2piia---	ἀγυιᾶτ	_5	
ἀγυιάς	n-p---fa-	ἀγυιός	_5	
ἀγυιὰς	n-p---fa-	ἀγυιός	_5	
ἀγχόνας	n-p---fa-	ἀγχόνη	_6	
ἀγωνίας	n-p---fa-	ἀγωνία	_6	
ἀδελφάν	n-s---ma-	ἀδελφάν	_6	
ἀδελφάς	n-p---fa-	ἀδελφή	_6	
ἀδελφάς	n-p---fa-	ἀδελφή	_6	
ἀδελφὰς	n-p---fa-	ἀδελφή	_6	
Ἀΐδαν	n-s---ma-	ᾅδης		
ἀδικίας	n-p---fa-	ἀδικία	_6	
ἀδμήτα	n-s---mv-	ἀδμήτης	_6	
ἁδονάν	n-s---ma-	ἁδονάς	_5	
Ἀδριηνᾶς	a-p---fa-	Ἀδριηνᾶς		
ἆἔα	v2spma---	ἆἔα	_1	
ἀειρομένας	v-pppefa-	ἀειρομένας	_9	
ἀείρας	v-sapamn-	ἀείρω	_5	
ἄρας	n-p---fa-	ἀείρω	_3	
ἄρας	v-sapamn-	ἀείρω	_3	
Ἀερίας	a-s---fg-	Ἀερῖος		
Ἀερόπας	n-p---fa-	Ἀερόπη		
Ἀζᾶσιν	n-p---md-	Ἀζᾶς		
Ἀθαναίας	a-p---fa-	Ἀθα	_7	
ἀθανάτας	a-p---fa-	ἀθανάτας	_7	
Ἀθᾶναι	a-p---fn-	Ἀθᾶνος	_5	
Ἀθάνας	n-p---fa-	ἀθῆναι		
Ἀθήνας	n-p---fa-	ἀθῆναι		
Ἀθήνας	n-s---fg-	ἀθῆναι		
Ἀθηναίας	n-s---fg-	Ἀθηναίη	_7	
Ἀθηναίας	n-p---fa-	Ἀθηναίη	_7	
Ἀθάνας	n-s---fg-	ἀθήνη		
Ἀθήνας	n-s---fg-	ἀθήνη		
ἀθλήσας	v-sapamn-	ἀθλέω	_6	
ἀθλίας	a-s---fg-	ἄθλιος	_5	
ἀθρήσας	v-sapamn-	ἀθρέω	_6	
ἀθροίσας	v-sapamn-	ἀθροίζω	_7	
Αἰακίδα	n-s---mv-	Αἰακίδας	_7	
Αἰακιδᾶν	n-p---mg-	αἰακίδης	_7	
αἴας	n-s---mn-	αἴας	_1	
Αἴας	n-s---mn-	αἴας		
Αἴας	n-s---mn-	Αἴας		
Αἰγαίας	n-s---fg-	Αἰγαίη		
αἴγλας	n-p---fa-	αἴγλη	_1	
Ἀίδα	n-s---mg-	Ἀίδα		
Ἀίδᾳ	n-s---mg-	Ἀίδᾳ		
Ἀΐδα	n-s---mg-	Ἀΐδα		
Ἀΐδᾳ	n-s---mg-	Ἀΐδᾳ		
Ἅιδᾳ	n-s---mg-	Ἅιδᾳ		
Ἀίδαν	n-s---ma-	Ἀίδαν		
Ἀίδας	n-s---mn-	Ἀίδας		
Ἀΐδᾳ	n-s---mg-	Ἀΐδας		
Ἀΐδας	n-s---mn-	Ἀΐδας		
Ἀΐδας	n-s---mn-	Ἀΐδης		
αἰθερίας	a-s---fg-	αἰθερῖος	_1	
αἰθερίας	a-p---fa-	αἰθερῖος	_1	
αἰκείας	a-p---fa-	αἰκεῖος	_1	
αἰκίας	n-s---fg-	αἰκία	_1	
αἱμάξας	v-sapamn-	αἱμάσσω	_4	
αἱματηράς	a-p---fa-	αἱματηρός	_4	
αἱματηρὰς	a-p---fa-	αἱματηρός	_4	
αἱμύλας	a-p---fa-	αἱμύλη	_1	
Αἰνέα	n-s---mv-	Αἰνέας		
Αἰνέαν	n-s---ma-	Αἰνέας		
Αἰνέας	n-s---mn-	αἰνείας		
αἰνέσας	v-sapamn-	αἰνέω	_1	
Αἰνιᾶνος	a-s---mg-	αἰνιάν		
αἰόλας	n-p---fa-	αἰόλας	_1	
αἰόλας	a-p---fa-	αἰόλος	_1	
ἀιόνας	n-p---fa-	ἀιόνη	_1	
ἀιστώσας	v-sapamn-	ἀιστοέω	_1	
αἰσυμνᾶι	v3spia---	αἰσυμνᾶιμι	_1	
αἰσχράς	a-p---fa-	αἰσχρός	_1	
αἰσχρὰς	a-p---fa-	αἰσχρός	_1	
αἰσχύνας	n-p---fa-	αἰσχύνη	_1	
αἰσχύνας	v2siia---	αἰσχύνω	_1	
αἰτίᾳ	n-s---fd-	αἰτία	_1	
αἰτίας	n-s---fg-	αἰτία	_1	
αἰτιᾶσθε	v2ppie---	αἰτιάομαι	_1	
Αἰτναίας	n-p---fa-	Αἰτναίη		
Αἴτνας	n-p---fa-	Αἴτνη		
Αἰτωλίας	n-s---fg-	Αἰτωλία		
αἰχμαλωτίδας	a-p---fa-	αἰχμαλωτίς	_5	
αἰχμαλωτίδας	n-p---fa-	αἰχμαλωτίς	_5	
αἰχμάς	n-p---fa-	αἰχμή	_1	
αἰχμὰς	n-p---fa-	αἰχμή	_1	
ἀκάκας	n-s---mn-	ἀκάκας	_5	
ἀκούσας	v-sapamn-	ἀκέω	_6	
ἀκμαίας	a-p---fa-	ἀκμαίη	_4	
ἀκμάς	n-p---fa-	ἀκμή	_4	
ἀκμάς	n-p---fa-	ἀκμή	_4	
ἀκμὰς	n-p---fa-	ἀκμή	_4	
ἀκοάς	n-p---fa-	ἀκοή	_4	
ἀκοὰς	n-p---fa-	ἀκοή	_4	
ἀκοίταν	n-s---ma-	ἀκοίτης	_6	
ἀκούσας	v-sapamn-	ἀκούω	_6	
Ἀκραίας	a-s---fg-	Ἀκραῖος	_6	
ἀκροτάτας	a-p---fas	ἀκρός	_8	
ἄκρας	n-s---fg-	ἄκρος	_4	
ἄκρας	a-p---fa-	ἄκρος	_4	
ἄκρας	n-p---fa-	ἄκρος	_4	
ἄκρας	a-s---fg-	ἄκρος	_4	
ἀκτᾶς	n-p---fa-	ἀκτᾶς	_4	
ἀκτάς	n-p---fa-	ἀκτή	_4	
ἀκτάς	n-p---fa-	ἀκτή	_4	
ἀκτὰς	n-p---fa-	ἀκτή	_4	
ἀκτᾶς	n-p---fa-	ἀκτή	_4	
ἀκτῖν’	n-s---fa-	ἀκτῖν	_4	
ἀκτῖνα	n-s---fa-	ἀκτῖνα	_4	
ἀκτῖνας	n-p---fa-	ἀκτῖνας	_4	
ἀκτῖνος	n-s---fg-	ἀκτῖνός	_4	
ἀκτῖσιν	n-p---fd-	ἀκτῖς	_4	
ἀλλοτρίας	a-s---fg-	ἀλ	_8	
ἀλαλᾶι	a-p---fn-	ἀλαλᾶ	_5	
ἀλαλαγάς	n-p---fa-	ἀλαλαγή	_7	
ἀλαλαγὰς	n-p---fa-	ἀλαλαγή	_7	
ἀλᾶσθαι	v--pne---	ἀλᾶμαι	_3	
ἀλᾶται	v3spia---	ἀλᾶμαι	_3	
ἀλωμένας	v-pppefa-	ἀλάομαι	_7	
ἀλᾶτα	d--------	ἀλᾶς	_3	
Ἁλάς	n-s---mn-	Ἁλάς		
ἀλάταν	n-s---ma-	ἀλάτας	_5	
ἀλάταν	a-s---ma-	ἀλάτας	_5	
ἀλάτας	n-s---mn-	ἀλάτας	_5	
ἀλάταν	n-s---ma-	ἀλάτης	_5	
ἀλγεινοτάτας	a-s---fgs	ἀλγεινός	_11	
ἀλγήσας	v-sapamn-	ἀλγέω	_6	
ἀλγηδόνας	n-p---fa-	ἀλγηδών	_8	
ἀλγῦναι	v--ana---	ἀλγῦναί	_4	
ἀλγύνεικυρήσας	v-sapamn-	ἀλγύνεικυράω	_13	
ἀληθείᾳ	n-s---fd-	ἀλήθεια	_7	
ἀληθείας	n-s---fg-	ἀλήθεια	_7	
ἀλήταν	n-s---ma-	ἀλήταν	_5	
ἁλιαδᾶν	n-p---mg-	ἁλιάδης	_6	
ἁλίσας	v-sapamn-	ἁλίζω	_5	
ἁλίας	a-p---fa-	ἁλίη	_4	
ἁλίας	a-p---fa-	ἁλίος	_4	
ἁλούσας	v-papafa-	ἁλίσκομαι	_6	
ἀλκᾷ	n-s---fd-	ἀλκά	_4	
ἀλκᾶς	n-s---fg-	ἀλκά	_4	
ἀλκᾶι	n-s---fd-	ἀλκᾶ	_4	
ἀλκᾷ	n-s---fn-	ἀλκᾷ	_4	
ἀλκᾶι	u--------	ἀλκᾶι	_4	
ἀλκάς	n-s---fg-	ἀλκάς	_4	
ἀλκὰς	n-s---fg-	ἀλκὰς	_4	
ἀλκᾶς	n-s---fg-	ἀλκᾶς	_4	
Ἀλκμήνας	n-s---fg-	ἀλκμήνη		
Ἀλκμήνας	n-p---fa-	ἀλκμήνη		
ἀλλαγᾷ	v1sria---	ἀλλαγᾷ	_6	
ἀλλαγᾷ	d--------	ἀλλαγᾷ	_6	
ἀλλάξας	v-sapamn-	ἀλλάσσω	_6	
ἀλλήλας	a-p---fa-	ἀλλήλας	_6	
ἀλλήλας	a-p---fa-	ἀλλήλων	_6	
ἄλλᾳ	a-p---na-	ἄλλος	_4	
ἄλλας	a-p---fa-	ἄλλος	_4	
ἀλλοτρίας	a-s---fg-	ἀλλότριος	_8	
ἅλμας	n-s---fg-	ἅλμας	_4	
ἁλμυρᾶς	a-s---fg-	ἁλμυρός	_6	
ἀλουσίας	n-p---fa-	ἀλουσίη	_7	
ἀλφηστᾶν	a-s---fa-	ἀλφηστᾶν	_7	
Ἀμαζόνας	n-p---fa-	ἀμαζών		
ἀμαθίας	n-s---fg-	ἀμαθία	_6	
ἀμαθίας	n-p---fa-	ἀμαθία	_6	
ἀμαιμακετᾶν	a-s---fa-	ἀμαιμακετᾶς	_6	
ἀμᾶν	n-s---na-	ἀμᾶν	_3	
ἁμαρτίας	n-p---fa-	ἁμαρτία	_7	
ἁμαρτίας	n-s---fg-	ἁμαρτία	_7	
ἀμαυρᾶς	n-s---fg-	ἀμαυρᾶς	_3	
ἀμαυρᾶς	a-s---fg-	ἀμαυρᾶς	_3	
ἀμαυρᾶς	n-s---fg-	ἀμαυρή	_3	
ἀμᾷ	v3spia---	ἀμάω	_3	
ἀμβάς	n-p---fa-	ἀμβή	_4	
ἀμβὰς	n-p---fa-	ἀμβή	_4	
ἀμβολάς	n-p---fa-	ἀμβολή	_6	
ἀμβολὰς	n-p---fa-	ἀμβολή	_6	
ἀμείψας	v-sapamn-	ἀμείβω	_6	
ἁμέρᾳ	n-s---fn-	ἁμέρᾳ	_5	
Ἁμέρας	a-s---fg-	Ἁμέρας		
ἀμέρσας	v-sapamn-	ἀμέρζω	_6	
ἁμέρα	n-d---fn-	ἁμέρη	_5	
ἁμέρας	n-s---fg-	ἁμέρη	_5	
ἁμετέρας	a-s---fg-	ἁμέτερος	_7	
ἀμηχανίας	n-s---fg-	ἀμηχανία	_8	
ἁμίλλας	n-s---mn-	ἁμίλ	_6	
ἁμιλλᾶι	n-p---fn-	ἁμιλλᾶ	_6	
ἁμίλλας	n-p---fa-	ἁμίλλα	_6	
ἁμίλλας	n-s---fg-	ἁμίλλα	_6	
ἁμιλλᾶσθαι	v--pne---	ἁμιλλάομαι	_6	
ἁμιλλᾶται	v3spie---	ἁμιλλάω	_6	
Ἀμμωνιάδας	n-p---fa-	Ἀμμωνιάδη		
ἀμοιβάς	n-p---fa-	ἀμοιβή	_6	
ἀμοιβὰς	n-p---fa-	ἀμοιβή	_6	
ἀμουσίας	n-p---fa-	ἀμουσίη	_7	
ἀμπείρας	n-p---fa-	ἀμπείρη	_7	
ἀμπετάσας	v-sapamn-	ἀμπετάζω	_8	
ἀμπετάσας	v-sapamn-	ἀμπετάω	_8	
ἀμπλακίας	n-s---fg-	ἀμπλακεία	_8	
ἀμπνοάς	a-s---mn-	ἀμπνοάς	_6	
ἀμπνοάς	n-p---fa-	ἀμπνοάς	_6	
ἀμπνοὰς	a-s---mn-	ἀμπνοὰς	_6	
ἀμῦναι	v--ana---	ἀμύνω	_3	
Ἀμφαναίας	a-p---fa-	Ἀμφαναί	_8	
ἀμφεστᾶσι	v3ppia---	ἀμφεστᾶσι	_7	
ἀμφιβᾶσα	v-sapafn-	ἀμφιβαίνω	_6	
ἀμφιβᾶσ’	v-sapafn-	ἀμφιβᾶσ	_6	
Ἀμφιονίας	a-s---fg-	Ἀμφιονῖος		
ἀμφιπτυχάς	v-sapamn-	ἀμφιπτυχά	_9	
Ἀμφιτρίτας	n-s---fg-	Ἀμφιτρί		
Ἀμφιτρίτας	n-s---fg-	Ἀμφιτρίτη		
ἀμφοτέρας	a-p---fa-	ἀμφότερος	_8	
ἀμφυγᾶς	v2sria---	ἀμφυγᾶς	_6	
ἀναβᾶσ’	v-sapafn-	ἀναβᾶσ	_5	
ἀναβοᾶι	v2spie---	ἀναβοᾶι	_6	
ἀναβοάσας	v-sapamn-	ἀναβοάσας	_8	
ἀναγκάσας	v-sapamn-	ἀναγκάζω	_8	
ἀναγκαίας	a-s---fg-	ἀναγκαῖος	_6	
ἀναγκαίας	a-p---fa-	ἀναγκαῖος	_6	
ἀνάγκας	n-p---fa-	ἀνάγκας	_6	
ἀνάγκας	n-p---fa-	ἀνάγκη	_6	
Ἀνάγκας	n-p---fa-	ἀνάγκη		
ἀναδεσμᾶν	n-s---na-	ἀναδεσμᾶις	_8	
ἀναιδείας	n-s---fg-	ἀναιδεία	_3	
ἀναιδείας	n-p---fa-	ἀναιδείη	_3	
ἀνακλάσας	v-sapamn-	ἀνακλάω	_8	
ἀναλώσας	v-sapamn-	ἀναλώζω	_7	
ἀνανδρίας	n-s---fg-	ἀνανδρία	_8	
ἄνα	n-s---mv-	ἄναξ	_3	
ἀναπτύξας	v-sapamn-	ἀναπτύσσω	_8	
ἀναρπάσας	v-sapamn-	ἀναρπάζω	_8	
ἀναρπάσας	v-sapamn-	ἀναρπάω	_8	
Ἀναρχίας	n-s---fg-	Ἀναρχία		
ἀνᾴσσων	v-sppamn-	ἀνᾴσσω	_3	
ἀναστᾶσ’	v-sapafn-	ἀναστᾶσ	_6	
ἀναστρέψας	v-sapamn-	ἀναστρέπω	_9	
ἀνατλάς	v-sapamn-	ἀνατλάς	_6	
ἀνατλὰς	v-sapamn-	ἀνατλὰς	_6	
ἀνατλᾶσα	v-sapafn-	ἀνατλᾶσα	_6	
ἀνατροπάς	n-p---fa-	ἀνατροπή	_8	
ἀναψυχάς	a-p---fa-	ἀναψυχάς	_7	
ἀναψυχὰς	a-p---fa-	ἀναψυχὰς	_7	
ἀναψυχάς	n-p---fa-	ἀναψυχή	_7	
ἀνδρείᾳ	n-s---fd-	ἀνδρεία	_7	
ἀνδρείας	n-s---fg-	ἀνδρεία	_7	
ἀνεβόα	v3siia---	ἀνεβόας	_6	
ἀνεωιγμένας	v-prpefa-	ἀνεωιγμένας	_10	
ἀνηβᾶι	a-p---fn-	ἀνηβᾶς	_5	
ἀνθήσας	v-sapamn-	ἀνθάω	_6	
ἀνίας	n-p---fa-	ἀνία	_4	
ἀνιᾷ	v3siia---	ἀνιάω	_4	
ἀνιᾷς	v2spia---	ἀνιάω	_4	
ἀνιᾶσθαι	v--pne---	ἀνιάω	_4	
ἀνειμένας	v-prpefa-	ἀνίημι	_8	
ἁνίκα	v3siia---	ἁνικάω	_5	
ἀναστάς	v-sapamn-	ἀνίστημι	_6	
ἀναστὰς	v-sapamn-	ἀνίστημι	_6	
ἀνοίας	n-s---fg-	ἄνοια	_5	
ἀνοίξας	v-sapamn-	ἀνοίγνυμι	_6	
ἀνοσιωτάτας	a-p---fa-	ἀνοσιωτάτας	_10	
ἀντᾶραι	v2spie---	ἀντᾶρω	_4	
ἀνταυδᾷς	v2spia---	ἀνταυδάω	_4	
ἀντήσας	v-sapamn-	ἀντάω	_6	
ἀντερᾶις	n-p---fd-	ἀντερᾶις	_6	
ἀντήσας	v-sapamn-	ἀντέω	_6	
ἀντηρέτας	v3siie---	ἀντηρέτας	_8	
ἀντηρέτας	n-p---fa-	ἀντηρέτη	_8	
ἀντιάσας	v-sapamn-	ἀντιάω	_7	
ἀντιβᾶσα	v-sapafn-	ἀντιβαίνω	_6	
ἀντιδρᾶν	v--pna---	ἀντιδρᾶν	_7	
ἀντιδρᾶν	v--pna---	ἀντιδράω	_7	
ἀντίας	a-p---fa-	ἀντίος	_5	
ἀντισηκώσας	v-sapamn-	ἀντισηκώζω	_10	
ἀντιστάς	v-sapamn-	ἀντισταίνω	_7	
ἀντιστὰς	v-sapamn-	ἀντισταίνω	_7	
Ἀντιτύπᾳ	a-s---fd-	ἀντίτυπος		
ἀντολάς	n-p---fa-	ἀντολή	_6	
ἀντολάς	n-p---fa-	ἀντολή	_6	
ἀντολὰς	n-p---fa-	ἀντολή	_6	
ᾄξασα	v-sapafn-	ᾄξασα	_1	
ᾄξας	n-p---fa-	ᾄξη	_1_3	
ἀξίνας	n-p---fa-	ἀξίνη	_5	
ἀξίας	a-s---fg-	ἄξιος	_4	
ἀξιώσας	v-sapamn-	ἀξιόω	_6	
ἄξας	v-sapamn-	ἄξω	_3	
ἆὀδύνη	u--------	ἆὀδύνη	_1	
ἀοιδάς	n-p---fa-	ἀοιδάς	_5	
ἀοιδάς	n-p---fa-	ἀοιδή	_5	
ἀοιδάς	n-p---fa-	ἀοιδή	_5	
ἀοιδὰς	n-p---fa-	ἀοιδή	_5	
ᾠδάς	n-p---fa-	ἀοιδή	_3	
ᾠδὰς	n-p---fa-	ἀοιδή	_3	
ἀπαιδίας	n-s---fg-	ἀπαιδία	_3	
ἀπήνας	v-sapamn-	ἀπαίνω	_5	
ἀπαιολᾶι	v3spia---	ἀπαιολᾶι	_3	
ἀπάρας	v-sapamn-	ἀπαίρω	_5	
ἀπαλλαγάς	n-p---fa-	ἀπαλλαγή	_8	
ἀπαλλαγάς	n-p---fa-	ἀπαλλαγή	_8	
ἀπαλλαγὰς	n-p---fa-	ἀπαλλαγή	_8	
ἀπαλλάξας	v-sapamn-	ἀπαλλάσσω	_8	
ἀπαντᾶι	v2spie---	ἀπαμᾶι	_6	
ἀπαντᾶν	v--pna---	ἀπαντάω	_6	
ἀπαντᾶν	a-s---ma-	ἀπαντάω	_6	
ἀπαντήσας	v-sapamn-	ἀπαντήω	_8	
ἀπᾴξας	v-sapamn-	ἀπᾴξας	_3_5	
ἀπαρχάς	n-p---fa-	ἀπαρχή	_6	
ἀπαρχὰς	n-p---fa-	ἀπαρχή	_6	
ἅπας	a-s---mn-	ἅπας	_3	
Ἅπας	a-s---mn-	ἅπας		
ἁπάσας	a-p---fa-	ἅπας	_5	
ἀπάτας	n-p---fa-	ἀπάτη	_5	
ἀπαυδᾶις	v2spia---	ἀπαυδᾶις	_3	
ἀπαυδᾶν	v--pna---	ἀπαυδάω	_3	
ἀπηύδα	v3siia---	ἀπαυδάω	_6	
ἀπηύρα	v3siia---	ἀπαυράω	_6	
ἀπούσας	v-pppafa-	ἀπάω	_6	
ἀπειθήσας	v-sapamn-	ἀπειθέω	_8	
ἀπειλάς	n-p---fa-	ἀπειλή	_6	
ἀπειλάς	n-p---fa-	ἀπειλή	_6	
ἀπειλὰς	n-p---fa-	ἀπειλή	_6	
ἀπεμπολᾶις	n-p---fd-	ἀπεμπολᾶις	_8	
ἀπεμπολᾶτε	v2pama---	ἀπεμπολᾶτε	_8	
ἀπεχθείας	n-s---fg-	ἀπεχθεία	_8	
ἀπημπόλα	v3siia---	ἀπημπόλα	_8	
ἀπήνας	v-sapamn-	ἀπήνη	_5	
Ἀπίας	a-s---mn-	ἄπιος		
Ἀπίας	a-s---fg-	ἄπιος		
ἀπιστίας	n-s---fg-	ἀπιστία	_7	
ἁπλᾶς	a-p---fa-	ἁπλᾶς	_4	
ἀπλοίᾳ	a-p---na-	ἀπλοίᾳ	_6	
ἀπλοίας	a-p---fa-	ἀπλοίας	_6	
ἀποζυγείσας	v-pppafa-	ἀπό	_10	
ἀποβάς	v-sapamn-	ἀποβαίνω	_5	
ἀποβλέψας	v-sapamn-	ἀποβλέπω	_8	
ἀποινᾶσθαι	v--anm---	ἀποινᾶσθαι	_6	
ἀποστᾶσα	v-sapafn-	ἀποίστημι	_6	
ἀποιχομένας	v-pppefa-	ἀποιχομένας	_10	
ἀποκλῖναι	v--ana---	ἀποκλῖναι	_6	
ἀποκρίνας	v-sapamn-	ἀποκρίνω	_8	
ἀποκρύψας	v-sapamn-	ἀποκρύπτω	_8	
ἀποκτείνας	v-sapamn-	ἀποκτείνω	_9	
ἀποκωκῦσαι	v--ana---	ἀποκωκῦζω	_7	
ἀπολέσας	v-sapamn-	ἀπόλλυμι	_7	
ἀπόλλυσιν	v3spia---	ἀπόλλυμι	_6	
ἀποπεμψαμένα	v-dapmfn-	ἀποπεμψαμένα	_12	
ἀπορίας	n-s---fg-	ἀπορία	_6	
ἀποσπάσας	v-sapamn-	ἀποσπάζω	_8	
Ἀποσπάσας	v-sapamn-	Ἀποσπάω		
ἀποστᾶσ’	v-sapafn-	ἀποστᾶσ	_6	
ἀποσυλᾶται	v3spie---	ἀποσυλάομαι	_7	
ἀποσυλήσας	v-sapamn-	ἀποσυλέω	_9	
ἀπουσίᾳ	n-s---fd-	ἀπουσία	_7	
ἀπουσίας	n-s---fg-	ἀπουσία	_7	
ἀπουσίας	n-s---fg-	ἀπουσίας	_7	
ἀποφθείρας	v-sapamn-	ἀποφθείρω	_9	
ἀποφθορᾷ	a-p---na-	ἀποφθορᾷ	_8	
ἀράς	n-p---fa-	ἀρά	_3	
ἀράς	v-sapamn-	ἀρά	_3	
ἀράς	n-p---fa-	ἀρά	_3	
Ἀράς	n-p---fa-	ἀρά		
Ἀράς	n-p---fa-	ἀρά		
ἀρὰς	n-p---fa-	ἀρά	_3	
ἀρὰς	v-sapamn-	ἀρά	_3	
Ἀρὰς	n-p---fa-	ἀρά		
ἀρᾶς	n-s---fg-	ἀρά	_3	
ἀρᾶς	n-p---fa-	ἀρά	_3	
ἀρᾷ	g--------	ἀρᾷ	_3	
τἄρα	v2spma---	ἄρα	_4	
Ἀραβίας	n-s---fg-	Ἀραβία		
ἀρᾶι	v3ppia---	ἀρᾶι	_3	
ἀρᾶν	n-p---fg-	ἀρᾶν	_3	
ἀρᾶται	v3srie---	ἀράομαι	_3	
ἀρᾶται	v3sase---	ἀράομαι	_3	
ἀράς	n-p---fa-	ἀράς	_3	
ἀράξας	v-sapamn-	ἀράσσω	_5	
ἀρβύλας	n-s---fg-	ἀρβύλα	_6	
ἀργᾶς	a-p---fa-	ἀργᾶς	_4	
Ἀργείας	a-s---fg-	Ἀργείας		
Ἀργείας	a-s---fg-	Ἀργεῖος		
Ἀργείας	a-p---fa-	Ἀργεῖος		
Ἀργείᾳ	a-s---fd-	̓ἀργεῖος		
ἀργίας	n-s---fg-	ἀργία	_5	
Ἀργόλας	a-s---mn-	Ἀργόλας		
Ἀρεθούσας	v-pppafa-	Ἀρεθούσας		
Ἀρείας	a-p---fa-	Ἀρείη		
ἀρετᾶι	n-p---fd-	ἀρετᾶι	_5	
ἀρετάς	n-p---fa-	ἀρετή	_5	
ἀρετὰς	n-p---fa-	ἀρετή	_5	
ἀρετᾶς	n-p---fa-	ἀρετή	_5	
ἀρετᾶς	n-s---fg-	ἀρετή	_5	
Ἀρετᾶς	n-s---fg-	ἀρετή		
ἀριστείας	n-s---fg-	ἀριστεία	_8	
ἀριστερᾶς	a-s---fg-	ἀριστερᾶ	_8	
ἀριστερᾶς	n-s---fg-	ἀριστερᾶ	_8	
ἀριστερᾶς	a-s---fg-	ἀριστερός	_8	
ἀριστεύσας	v-sapamn-	ἀριστεύω	_9	
ἀρίστας	a-p---fa-	ἄριστος	_6	
Ἀρκάς	n-s---mn-	ἀρκάς		
Ἀρκὰς	n-s---mn-	ἀρκάς		
Ἀρκάς	n-s---mn-	Ἀρκάς		
Ἀρκάς	n-p---fa-	Ἀρκάς		
ἀρκέσας	v-sapamn-	ἀρκέω	_6	
ἁρματεύσας	v-sapamn-	ἁρματεύσας	_9	
ἁρμόσας	v-sapamn-	ἁρμόζω	_6	
Ἁρμονίας	n-s---fg-	Ἁρμονία		
Ἁρμονίᾳ	n-s---fn-	Ἁρμονίᾳ		
ἄρα	n-s---fg-	ἄρος	_3	
ἀρούρας	n-p---fa-	ἄρουρα	_6	
ἁρπαγάς	n-p---fa-	ἁρπαγή	_6	
ἁρπαγάς	n-p---fa-	ἁρπαγή	_6	
ἁρπαγὰς	n-p---fa-	ἁρπαγή	_6	
ἁρπάσας	v-sapamn-	ἁρπάζω	_6	
ἀρτάνας	n-p---fa-	ἀρτάνη	_6	
ἀρτήσας	v-sapamn-	ἀρτάω	_6	
ἀρτηρίας	n-s---fg-	ἀρτηρία	_7	
ἀρτίας	a-p---fa-	ἀρτῖος	_5	
ἀρχαίας	a-s---fg-	ἀρχαῖος	_4	
ἀρχαίας	a-p---fa-	ἀρχαῖος	_4	
ἀρχᾶς	n-p---fa-	ἀρχᾶς	_4	
ἀρχέταν	n-s---ma-	ἀρχέτης	_6	
ἀρχέτας	n-s---mn-	ἀρχέτης	_6	
ἀρχάν	n-s---ma-	ἀρχή	_4	
ἀρχάς	n-p---fa-	ἀρχή	_4	
ἀρχάς	n-p---fa-	ἀρχή	_4	
ἀρχὰς	n-p---fa-	ἀρχή	_4	
ἀρχᾶς	n-p---fa-	ἀρχή	_4	
ἄρξας	v-sapamn-	ἄρχω	_4	
ἀρωγάν	v3siia---	ἀρωγάν	_5	
ἀρωγάς	n-p---fa-	ἀρωγή	_5	
ἀρωγὰς	n-p---fa-	ἀρωγή	_5	
Ἀσίας	n-s---fg-	ἀσία		
ἆσίγα	u--------	ἆσίγα	_1	
Ἀσιητᾶν	a-s---fa-	Ἀσιητᾶν		
ἀσκήσας	v-sapamn-	ἀσκέω	_6	
ἀσμένας	a-p---fa-	ἀσμένας	_6	
ἀσπίδας	n-p---fa-	ἀσπίς	_6	
ἀσπιστάς	a-p---fa-	ἀσπιστός	_7	
ἀσπιστὰς	a-p---fa-	ἀσπιστός	_7	
ἀστραβιζούσας	v-pppafa-	ἀστραβιζούσας	_12	
ἀστραπᾶν	n-s---fa-	ἀστραπᾶ	_7	
ἀστραπάς	n-p---fa-	ἀστραπή	_7	
ἀστυγειτονουμένας	v-pppefa-	ἀστυγειτονόομαι	_16	
ἀσυλίᾳ	n-s---fd-	ἀσυλία	_6	
ἀσυνεσίας	n-p---fa-	ἀσυνεσίη	_8	
ἁσυχαίᾳ	n-s---fd-	ἁσυχαία	_5	
ἀσφάδᾳστος	a-s---mn-	ἀσφάδᾳστος	_6	
ἀσφαλείᾳ	n-s---fd-	ἀσφάλεια	_8	
ἀσχαλᾶν	v--pna---	ἀσχαλᾶν	_6	
Ἀσωπίας	n-s---fg-	Ἀσωπία		
ἄτᾳ	n-s---fa-	ἄτᾳ	_3	
ἀταλᾶς	a-s---fn-	ἀταλᾶς	_5	
ἄτας	n-p---fa-	ἄτας	_3	
ἀτᾷ	v3spia---	ἀτάω	_3	
ἀτᾶν	n-s---fa-	ἀτάω	_3	
ἄτᾳ	n-s---fa-	ἄτη	_3	
ἄτᾳ	n-s---fd-	ἄτη	_3	
ἄτας	n-s---fg-	ἄτη	_3	
ἄτας	n-p---fa-	ἄτη	_3	
Ἄτας	n-s---fg-	ἄτη		
ἀτηρᾷ	a-p---na-	ἀτηρός	_5	
ἀτηρᾶς	a-s---fg-	ἀτηρός	_5	
ἀτηρᾶς	a-p---fa-	ἀτηρός	_5	
Ἀτθίδας	n-p---fa-	Ἀτθίς		
ἀτιμάσας	v-sapamn-	ἀτιμάζω	_7	
ἀτιμάσας	v-sapamn-	ἀτιμάσας	_7	
ἀτιμίᾳ	n-s---fd-	ἀτιμία	_6	
ἀτιμίας	n-s---fg-	ἀτιμία	_6	
Ἀτιμίας	n-s---fg-	ἀτιμία		
ἀτίτας	n-p---fa-	ἀτίτη	_5	
Ἄτλας	n-p---fa-	ἄτλας		
Ἄτλας	n-s---mn-	ἄτλας		
Ἀτρειδᾶν	n-p---mg-	̓ἀτρείδης		
αὐγάς	n-p---fa-	αὐγή	_1	
αὐγάς	n-p---fa-	αὐγή	_1	
αὐγὰς	n-p---fa-	αὐγή	_1	
αὐδά	v2spma---	αὐδά	_1	
αὔδα	v2spma---	αὔδα	_1	
αὔδα	v2spma---	αὐδάω	_1	
Αὔδα	v2spma---	αὐδάω		
ηὔδα	v3siia---	αὐδάω	_4	
ηὔδας	v2siia---	αὐδάω	_4	
Ηὐδᾶτο	v3siie---	αὐδάω		
αὐδάν	n-s---ma-	αὐδή	_1	
αὐδὰν	n-s---ma-	αὐδή	_1	
αὐθαδίᾳ	n-s---fd-	αὐθαδία	_4	
αὐθαδίας	n-s---fg-	αὐθαδία	_4	
αὐλάς	n-p---fa-	αὐλή	_1	
αὐλὰς	n-p---fa-	αὐλή	_1	
αὔρας	n-s---fg-	αὔρη	_1	
ἀυτᾶς	u--------	ἀυτᾶς	_1	
αὑτᾶςἔτλας	a-p---fa-	αὑτᾶςἔτλας	_1	
αὐτάς	a-p---fa-	αὐτός	_1	
αὐτάς	a-p---fa-	αὐτός	_1	
αὐτὰς	a-p---fa-	αὐτός	_1	
ἀΰσας	v-sapamn-	αὔω	_4	
Ἀφαίας	n-p---fa-	Ἀφαίη	_5	
Ἀφαίας	a-s---fg-	Ἀφαίη	_5	
ἀφιᾶσιν	v3ppia---	ἀφιᾶμι	_4	
ἀφιᾶσ’	v3ppia---	ἀφιᾶσ	_4	
ἀφῖγμαι	v1spie---	ἀφῖγμαι	_3	
ἀφῖγμαι	v1srie---	ἀφῖγμαι	_3	
ἀφῖξαι	v--ana---	ἀφῖγω	_3	
ἀφῖκται	v3srie---	ἀφικνέομαι	_3	
ἀφῖχθαι	v--rne---	ἀφικνέομαι	_3	
ἀφῖκτο	v3saim---	ἀφῖκτο	_3	
ἀφῖξαι	v--ana---	ἀφῖσσω	_3	
ἀποστάς	v-sapamn-	ἀφίστημι	_6	
ἀποστὰς	v-sapamn-	ἀφίστημι	_6	
ἀφῖξαι	v2samm---	ἀφῖχομαι	_3	
ἀφορμᾷ	v3spia---	ἀφορμάζω	_6	
ἀφορμᾷς	v2spia---	ἀφορμάω	_6	
ἀφορμᾶσθαι	v--pne---	ἀφορμάω	_6	
ἀφορμάς	n-p---fa-	ἀφορμή	_6	
ἀφορμάς	n-p---fa-	ἀφορμή	_6	
ἀφορμὰς	n-p---fa-	ἀφορμή	_6	
Ἀφροδίτας	n-p---fa-	Ἀφροδί		
Ἀφροδίτας	n-s---fg-	Ἀφροδί		
Ἀφροδίτας	n-p---fa-	Ἀφροδίτη		
Ἀφροδίτας	n-s---fg-	Ἀφροδίτη		
ἀφροσύνας	n-p---fa-	ἀφροσύνα	_8	
ἀφροσύνας	n-s---fg-	ἀφροσύνα	_8	
ἀφροσύνας	n-p---fa-	ἀφροσύνη	_8	
ἀχά	a-d---mn-	ἀχά	_3	
Ἀχαιικάς	a-p---fa-	Ἀχαιικός	_7	
Ἀχαιικὰς	a-p---fa-	Ἀχαιικός	_7	
ἀχάν	a-s---ma-	ἀχάν	_3	
ἀχὰν	a-s---ma-	ἀχὰν	_3	
ἀχέτας	n-s---mn-	ἀχέτης	_5	
Ἀχιλείας	n-s---fg-	Ἀχίλεια		
ἀχλαινίας	a-s---fg-	ἀχλαίνιος	_4	
ἁψῖδα	n-s---fa-	ἁψῖδα	_3	
ἀψυχίᾳ	n-s---fn-	ἀψυχία	_6	
ἀψυχίᾳ	n-s---fd-	ἀψυχία	_6	
ἀψυχίας	n-s---fg-	ἀψυχία	_6	
βαθειᾶν	a-p---fg-	βαθειᾶν	_6	
βαθρείας	n-s---fg-	βαθρεία	_7	
βαθρείας	n-s---fg-	βαθρεῖα	_7	
βαθείᾳ	a-s---fd-	βαθύς	_6	
βαθείας	a-s---fg-	βαθύς	_6	
βαιάν	v2spma---	βαιάν	_2	
βάς	v-sapamn-	βαίνω	_2	
βὰς	v-sapamn-	βαίνω	_2	
ἔβα	v3siia---	βαίνω	_3	
βακχᾶν	u--------	βακχᾶν	_5	
βακχᾶν	n-s---ma-	βακχᾶς	_5	
Βακχᾶν	n-s---fa-	Βακχᾶς	_5	
βακχᾷ	d--------	βακχᾷς	_5	
βάκχας	n-s---mn-	βάκχας	_5	
βακχείας	n-s---fg-	βακχείη	_7	
βακχείας	n-p---fa-	βακχεῖος	_7	
βακχίας	a-s---fg-	βάκχειος	_6	
Βακχίας	a-s---fg-	βάκχειος	_6	
βακχεύσας	v-sapamn-	βακχεύω	_8	
βάκχας	n-p---fa-	βάκχη	_5	
Βακχιώτας	n-s---fg-	Βακχιώ	_8	
βαλβῖδα	n-s---fa-	βαλβίς	_5	
βαλιάν	n-s---ma-	βαλιὰς	_5	
βαλιὰν	n-s---ma-	βαλιὰς	_5	
βαρυποτμωτάτας	a-s---fgs	βαρυποτμωτάτας	_13	
βαρείᾳ	a-s---fd-	βαρύς	_6	
βαρείας	a-p---fa-	βαρύς	_6	
βαρείας	a-s---fg-	βαρύς	_6	
βάς	v-sapamn-	βάς	_2	
βασιλείας	n-s---fg-	βασιλεία	_8	
βαφάς	n-p---fa-	βαφή	_4	
βαφάς	n-p---fa-	βαφή	_4	
βαφὰς	n-p---fa-	βαφή	_4	
βεβώσας	v-prpafa-	βεβόω	_6	
βεβρωμένας	v-prpefa-	βεβρωμένας	_9	
βίᾳ	n-s---fd-	βία	_3	
βίας	n-s---fg-	βία	_3	
βίᾳ	u--------	βίᾳ	_3	
βιαίας	a-s---fg-	βίαιος	_3	
βιᾶται	v3spie---	βιάω	_3	
βιοτᾶς	n-s---fg-	βιοτᾶ	_5	
βιοτᾶι	n-p---mn-	βιοτᾶι	_5	
βιοτᾶς	n-p---fa-	βιοτᾶς	_5	
βλάβας	n-p---fa-	βλάβη	_5	
βλάστας	n-p---fa-	βλάστη	_6	
βλέψας	v-sapamn-	βλέπω	_5	
βόα	v2spma---	βόα	_3	
βοάς	n-p---fa-	βοή	_3	
βοηδρομήσας	v-sapamn-	βοηδρομέω	_10	
βολάς	n-p---fa-	βολή	_4	
βολάς	n-p---fa-	βολή	_4	
βολὰς	n-p---fa-	βολή	_4	
βοράν	n-s---ma-	βορά	_4	
βορέα	n-s---mg-	βορέας	_5	
βοσκάς	n-p---fa-	βοσκή	_5	
βοσκὰς	n-p---fa-	βοσκή	_5	
βουλεύσας	v-sapamn-	βουλεύω	_8	
βουλάς	n-p---fa-	βουλή	_5	
βουλὰς	n-p---fa-	βουλή	_5	
βούταν	n-s---ma-	βούτας	_5	
βούτας	n-s---mn-	βούτας	_5	
βούταν	n-s---ma-	βούτης	_5	
βραβείας	n-p---fa-	βράβεια	_7	
Βραυρωνίας	a-p---fa-	Βραυρωνῖος		
βραχείας	a-s---fg-	βραχύς	_7	
βρέτας	n-p---fa-	βρές	_5	
βρέτας	n-p---fa-	βρέται	_5	
βρέτας	n-p---fa-	βρέτη	_5	
βρέτας	n-p---fa-	βρέτης	_5	
βρίσας	v-sapamn-	βρίζω	_5	
βροτείας	n-s---fg-	βροτεία	_7	
βροτείας	n-p---fa-	βροτείη	_7	
βφρονωγάρ	v2spma---	βφρονωγάρ	_8	
γαίας	n-s---fg-	γαῖα	_2	
γαίας	n-s---fg-	γαίας	_2	
γᾶκαπφθίμενον	v-sapmma-	γᾶκαπφθίω	_2	
γαλακτοπότας	n-s---mn-	γαλακτοπότας	_11	
γαλανείας	n-p---fa-	γαλανεία	_8	
γαλάνας	a-p---fa-	γαλάνη	_6	
γαμετᾶν	n-s---fa-	γαμετᾶν	_6	
γαμετᾶν	n-s---ma-	γαμετᾶν	_6	
γαμέτᾳ	n-s---fd-	γαμέτᾳς	_6	
γαμέτας	n-s---mn-	γαμέτης	_6	
γαμουμένας	v-pppefa-	γαμεύω	_9	
γήμας	v-sapamn-	γαμέω	_4	
γεγυμνάκασιν	v3pria---	γεγυμνάκασιν	_9	
γέννας	n-p---fa-	γέν	_5	
γενειάδας	n-p---fa-	γενειάς	_8	
γενέτα	n-s---mv-	γενέτης	_6	
γενέταν	n-s---ma-	γενέτης	_6	
γενέτας	n-s---mn-	γενέτης	_6	
γέννας	n-s---fg-	γέννα	_5	
γενναίας	a-s---fg-	γενναῖος	_5	
γέννας	n-s---fg-	γέννας	_5	
γεννήσας	v-sapamn-	γεννάω	_7	
γεραιάς	a-p---fa-	γεραιός	_4	
γεραιάς	a-p---fa-	γεραιός	_4	
γεραιὰς	a-p---fa-	γεραιός	_4	
γέρας	n-s---na-	γέρας	_4	
γέρας	n-s---nn-	γέρας	_4	
γεφύρας	n-p---fa-	γέφυρα	_6	
γηγενέτας	a-s---mn-	γηγενέτας	_8	
γίγας	n-s---mn-	γίγας	_4	
γλυφίδας	n-p---fa-	γλυφίς	_7	
γλώσσας	n-p---fa-	γλῶσσα	_6	
γνώμας	n-p---fa-	γνώμη	_5	
γνώμας	n-s---fg-	γνώμη	_5	
γονάς	n-p---fa-	γονάς	_4	
γονάς	n-p---fa-	γονή	_4	
γονὰς	n-p---fa-	γονή	_4	
γονίας	n-s---fg-	γονία	_5	
Γοργόνας	n-p---fa-	Γοργόνες		
γραίας	n-s---fg-	γραεία	_3	
γραίας	n-p---fa-	γραῖος	_3	
γραίας	n-s---fg-	γραῖος	_3	
γραίας	a-p---fa-	γραῖος	_3	
γραφάς	n-p---fa-	γραφή	_5	
γραφάς	n-p---fa-	γραφή	_5	
γραφὰς	n-p---fa-	γραφή	_5	
γεγραμμένας	v-prpefa-	γράφω	_10	
γράψας	v-sapamn-	γράφω	_5	
γυᾶν	n-s---mn-	γυᾶν	_3	
γύας	n-s---mn-	γύης	_3	
γυίας	n-p---fa-	γυῖα	_4	
γυίας	n-p---fa-	γυίας	_4	
γυμνάς	a-p---fa-	γυμνός	_5	
γυμνὰς	a-p---fa-	γυμνός	_5	
γυναικείας	a-p---fa-	γυναικεῖος	_4	
γυπιάς	n-s---fg-	γυπιὰ	_5	
γυπιὰς	n-s---fg-	γυπιὰ	_5	
δᾴαν	v1saia---	δᾴαν	_2	
δαΐας	n-s---fg-	δαΐη	_4	
δαΐξας	v-sapamn-	δαΐξας	_5	
δακρῦον	n-s---nn-	δακρῦον	_5	
δακρῦσαι	v--ana---	δακρύω	_5	
δακρῦσαι	v--ana---	δακρύω	_5	
δακρύσας	v-sapamn-	δακρύω	_7	
δακρῦσαι	v--ana---	δακρῦω	_5	
δαμάλας	n-p---fa-	δαμάλη	_6	
δαμίας	a-s---fg-	δάμιος	_5	
Δανάας	n-s---fg-	δανάη	_5	
δαναιᾶν	n-s---fa-	δαναιᾶ	_4	
Δαναϊδᾶν	n-p---mg-	Δαναϊδᾶν	_7	
Δαρδανίδας	n-s---mn-	Δαρδανίδης	_9	
Δαρδανίδας	n-p---fa-	Δαρδανίδης	_9	
Δαρδανίας	a-p---fa-	Δαρδανῖος	_8	
Δαριᾶνα	a-p---na-	Δαριᾶνος	_5	
δατητάς	n-p---fa-	δατητάς	_6	
δατητὰς	n-p---fa-	δατητὰς	_6	
Δαυλίας	n-p---fa-	Δαυλία		
δάφνας	n-s---fg-	δάφ	_5	
δάφνας	n-p---fa-	δάφνη	_5	
δείσας	v-sapamn-	δείδω	_5	
Δείκνυμι	v1spia---	δείκνυμι		
δεικνύς	v-sppamn-	δείκνυμι	_6	
δεικνὺς	v-sppamn-	δείκνυμι	_6	
δείκνυσιν	v3spia---	δείκνυμι	_6	
δείξας	v-sapamn-	δείκνυμι	_5	
δειλαίας	a-s---fg-	δείλαιος	_5	
δειλίᾳ	n-s---fd-	δειλία	_6	
δειλίας	n-s---fg-	δειλία	_6	
δεινάς	a-p---fa-	δεινός	_5	
δεινάς	a-p---fa-	δεινός	_5	
δεινὰς	a-p---fa-	δεινός	_5	
δεινοτάτας	a-s---fgs	δεινός	_9	
δειράδας	n-p---fa-	δειράδας	_7	
δειράδας	n-p---fa-	δειράς	_7	
δέμας	n-s---nn-	δέμας	_4	
δέμας	n-s---na-	δέμας	_4	
δεξιᾶι	a-p---fn-	δεξιᾶι	_5	
δεξιᾶι	a-s---fd-	δεξιᾶι	_5	
δεξιᾶς	u--------	δεξιᾶς	_5	
δεξιάς	a-p---fa-	δεξιός	_5	
δεξιᾶς	a-s---fg-	δεξιός	_5	
δεξιᾶς	a-p---fa-	δεξιός	_5	
δέπας	n-s---na-	δέπας	_4	
δέρας	n-p---fa-	δέρη	_4	
δέραν	n-s---ma-	δέρης	_4	
δεσποίνας	n-s---fg-	δέσποινα	_8	
δεσπόταν	n-s---ma-	δεσπότης	_7	
δήσας	v-sapamn-	δέω	_4	
δέρας	n-p---fa-	δήρ	_4	
διαβάς	v-sapamn-	διαβαίνω	_5	
διαβὰς	v-sapamn-	διαβαίνω	_5	
διαγελᾶις	v2spsa---	διαγελᾶις	_7	
διαγελᾶις	v2spia---	διαγελᾶις	_7	
διαδρομᾶν	v--pna---	διαδρομάω	_8	
διαίτᾳ	a-s---fd-	διαί	_3	
διαιτᾶσθαι	v--pne---	διαιτᾶμαι	_3	
διαιτᾶσθαι	v--pne---	διαιτάομαι	_3	
διακωλῦσαι	v--ana---	διακωλύω	_7	
διαλλαγάς	n-p---fa-	διαλλαγή	_8	
διαλλαγάς	n-p---fa-	διαλλαγή	_8	
διαλλαγὰς	n-p---fa-	διαλλαγή	_8	
διαμείψας	v-sapamn-	διαμείπτω	_8	
διαμοιρᾶσαι	v--ana---	διαμοιρᾶζω	_8	
διανοίᾳ	n-s---fd-	διάνοια	_7	
διανοίας	n-s---fg-	διάνοια	_7	
διανοίας	n-p---fa-	διάνοια	_7	
διανομάς	n-p---fa-	διανομή	_7	
διανομὰς	n-p---fa-	διανομή	_7	
διαπείρας	n-p---fa-	διαπείρη	_8	
διαπερᾶν	v--pna---	διαπερᾶ	_7	
διαπερᾶν	a-s---fa-	διαπεράω	_7	
διαπήλας	v-sapamn-	διαπήλλω	_7	
διαπωτᾶται	v3spie---	διαπωτάομαι	_7	
διαρροάς	n-p---fa-	διαρροάς	_7	
διασιωπήσας	v-sapamn-	διασιωπάω	_10	
διᾴσσει	v3spia---	διᾴσσει	_3	
διαφθοράς	n-p---fa-	διαφθορά	_8	
διαφθοράς	n-p---fa-	διαφθορὰ	_8	
διαφθορὰς	n-p---fa-	διαφθορὰ	_8	
διαφθοράς	n-p---fa-	διαφθοράς	_8	
διαχαλᾶτε	v2prma---	διαχαλάω	_7	
διδύμας	a-s---fg-	διδύμας	_6	
διεκπερᾶν	v--pna---	διεκπεράω	_8	
διεμπολᾷ	v1saia---	διεμπολᾷ	_8	
διελθούσας	v-papafa-	διέρχομαι	_9	
δικαίας	a-p---fa-	δίκαιος	_4	
δικαίας	a-s---fg-	δίκαιος	_4	
δικέλλας	n-p---fa-	δικέλλη	_7	
δίκᾳ	n-s---fd-	δίκη	_4	
Δίκᾳ	a-p---na-	δίκη		
δίκας	n-s---fg-	δίκη	_4	
δίκας	n-p---fa-	δίκη	_4	
Δίκας	n-p---fa-	δίκη		
Δίκας	n-s---fg-	δίκη		
δίνᾳ	u--------	δίνᾳ	_4	
δῖναινεφέλας	n-p---fa-	δῖναινεφέλη	_2_4	
δίνας	n-p---fa-	δίνας	_4	
δίνας	n-p---fa-	δίνη	_4	
διολέσας	v-sapamn-	διολέθω	_7	
διολέσας	v-sapamn-	διόλλυμι	_7	
διολλῦσαι	v-pppafn-	διολλῦσαι	_6	
διόπτας	v-sapamn-	διόπτης	_6	
δίας	a-s---fg-	δῖος	_3	
δίας	n-s---fg-	δῖος	_3	
διώσας	v-sapamn-	διόω	_5	
διπλᾶ	u--------	διπλᾶ	_5	
διπλᾶ	a-p---na-	διπλόος	_5	
διπλᾶ	a-p---nn-	διπλόος	_5	
διπλᾶς	a-p---fa-	διπλόος	_5	
Δίρκας	a-s---fg-	Δίρκη		
Δίρκας	a-p---fa-	Δίρκος		
δισσάς	a-p---fa-	δισσάς	_5	
δισσάς	a-p---fa-	δισσάς	_5	
δισσὰς	a-p---fa-	δισσὰς	_5	
δμωίδας	n-p---fa-	δμωίδας	_6	
δνοφεράς	a-p---fa-	δνοφερὰ	_7	
δνοφερὰς	a-p---fa-	δνοφερὰ	_7	
δοθείσας	v-prpefa-	δοθείσας	_7	
δοκήσας	v-sapamn-	δοκέω	_6	
δόξας	v-sapamn-	δοκέω	_4	
δολίας	a-p---fa-	δολί	_5	
δολίας	a-s---fg-	δολῖος	_5	
δολώσας	v-sapamn-	δολόω	_6	
δολώσας	v-sapamn-	δολώσας	_6	
δόξας	n-p---fa-	δόξα	_4	
δοράς	n-p---fa-	δορά	_4	
δορὰς	n-p---fa-	δορά	_4	
Δοτάμας	n-s---nn-	Δοτάμας	_6	
δουλείας	n-s---fg-	δουλεία	_7	
δουλίας	a-s---fg-	δουλεία	_6	
δούλας	n-s---fg-	δούλη	_5	
δουλίᾳ	a-p---nn-	δουλίᾳ	_6	
δουλοσύνας	n-s---fg-	δουλοσύνα	_9	
δουλώσας	v-sapamn-	δουλόω	_7	
δοχμιᾶν	a-s---fa-	δοχμιᾶν	_6	
δραπέταν	v3siia---	δραπέταν	_7	
δράσας	v-sapamn-	δράσας	_5	
δράσας	v-sapamn-	δράω	_5	
δράτω	v3spma---	δράω	_3	
Δράτω	v3spma---	δράω		
δρομάς	n-p---fa-	δρομή	_5	
δρομὰς	n-p---fa-	δρομή	_5	
δροσεράς	a-p---fa-	δροσερός	_7	
δροσερὰς	a-p---fa-	δροσερός	_7	
δύᾳ	u--------	δύᾳ	_3	
δύᾳ	a-p---nn-	δύᾳ	_3	
δύας	n-p---fa-	δύας	_3	
δύας	n-p---fa-	δύες	_3	
δύᾳ	n-s---fn-	δύη	_3	
δύας	n-p---fa-	δύη	_3	
δύνᾳ	v1siia---	δύνᾳ	_4	
δύνᾳ	v2spma---	δύνᾳ	_4	
δύνᾳ	v2spie---	δύνᾳμι	_4	
δυναστείας	n-s---fg-	δυναστεία	_9	
δυνάστα	n-s---mv-	δυνάστης	_7	
δυνάστας	n-s---mn-	δυνάστης	_7	
δυσαυλίας	n-s---fg-	δυσαυλία	_4	
δυσβουλίας	n-s---fg-	δυσβουλία	_9	
δυσγενείας	n-s---fg-	δυσγενεία	_9	
δυσθυμίας	n-s---fg-	δυσθυμία	_8	
δυσκλεᾶ	a-s---fa-	δυσκλεᾶ	_7	
δυσκλεᾶς	a-s---mn-	δυσκλεᾶς	_7	
δυσκλείᾳ	n-s---fd-	δύσκλεια	_8	
δυσμᾶν	v2sama---	δυσμᾶν	_5	
δυσμενείᾳ	n-s---fd-	δυσμενεία	_9	
δυσοσμίας	n-s---fg-	δυσοσμία	_8	
δυσπραξίας	n-p---fa-	δυσπραξία	_9	
δυσπραξίας	n-s---fg-	δυσπραξία	_9	
δυσσεβείας	n-s---fg-	δυσσεβείη	_9	
δυσσεβίας	a-s---fg-	δυσσεβῖος	_8	
δυστανοτάτας	a-s---fgs	δυστανός	_11	
δυστανοτάτας	a-p---fas	δυστανοτάτας	_11	
δυσχλαινίας	n-p---fa-	δυσχλαινία	_6	
δωματῖτιν	n-s---fa-	δωματῖτιν	_6	
Δωρικάς	a-p---fa-	Δωρικά		
ἔα	v2spma---	ἔα	_2	
Ἔα	v2spma---	ἔα		
ἐαεὐνάς	n-p---fa-	ἐαεὐνάς	_6	
ἔαεὐνας	n-p---fa-	ἔαεὐνὰς	_6	
ἔα	v2spma---	ἐάω	_2	
Ἔα	v2spma---	ἐάω		
ἐάσας	v-sapamn-	ἐάω	_4	
εἴα	v3siia---	ἐάω	_3	
ἑβδόμας	a-p---fa-	ἕβδομος	_6	
ἐγκαθηβᾶν	v1saia---	ἐγκαθηβάω	_8	
ἐγκαθιδρῦσαι	v--ana---	ἐγκαθιδρῦζω	_9	
ἐγκαταζεύξας	v-sapamn-	ἐγκαταζεύσσω	_11	
ἐγκατιλλώψας	v-sapamn-	ἐγκατιλλώπτω	_11	
ἐγκλῄσας	v-sapamn-	ἐγκλείω	_7	
ἔδρας	n-p---fa-	ἔδρα	_4	
ἕδρας	n-p---fa-	ἕδρα	_4	
ἕδρας	n-s---fg-	ἕδρα	_4	
ἐθείρας	v-sapamn-	ἐθείρω	_6	
εἰδυίας	v-sppafg-	εἰδυίας	_6	
εἰλαπίνας	n-p---fa-	εἰλαπίνη	_8	
εἰλατίνας	a-p---fa-	εἰλατίνη	_8	
εἰληγμένας	v-prpefa-	εἰληγμένας	_9	
εἱλιςσομένας	n-s---fg-	εἱλις	_11	
εἱλίξας	v-sapamn-	εἱλίσσω	_6	
εἱλόμανἀνατροπας	n-p---fa-	εἱλόμανἀνατροπάς	_15	
οὔσας	v-pppafa-	εἰμί	_4	
ἰούσας	v-pppafa-	εἶμι	_5	
εἰναλίας	a-p---fa-	εἰναλίη	_7	
εἰναλίας	a-s---fg-	εἰναλῖος	_7	
εἰρεσίας	n-s---fg-	εἰρεσία	_7	
μιᾷ	a-s---fd-	εἷς	_3	
μιᾶς	a-s---fg-	εἷς	_3	
Μιᾶς	a-s---fg-	εἷς		
εἰσακούσας	v-sapamn-	εἰσακούω	_9	
ἐσβολάς	n-p---fa-	εἰσβολή	_6	
εἰσόρα	v2spma---	εἰσόρα	_6	
εἰσορᾶτε	v2ppia---	Εἰσορᾶτέ	_6	
Ἑκάτας	n-s---fg-	Ἑκάτα	_5	
ἐκβάς	v-sapamn-	ἐκβαίνω	_4	
ἐκβὰς	v-sapamn-	ἐκβαίνω	_4	
ἐκβακχευσαμένα	v-dapmfn-	ἐκβακχευσαμένα	_14	
ἐκβολάς	n-p---fa-	ἐκβολάς	_6	
ἐκβολάς	n-p---fa-	ἐκβολή	_6	
ἐκβολὰς	n-p---fa-	ἐκβολή	_6	
ἐκδακρῦσαι	v2spie---	ἐκδακρῦσαί	_7	
ἐκδακρῦσαι	v2spie---	ἐκδακρῦσω	_7	
ἐκείνας	a-p---fa-	ἐκεῖνος	_6	
κείνας	a-p---fa-	ἐκεῖνος	_5	
ἐκκαλύψας	v-sapamn-	ἐκκαλύπτω	_8	
ἐκκενουμένα	v-dppefn-	ἐκκενουμένα	_11	
ἐκκλησίας	n-p---fa-	ἐκκλησία	_8	
ἐκκολυμβᾶν	v3siia---	ἐκκολυμβάω	_9	
ἐκκομπάσας	v-sapamn-	ἐκκομπάζω	_9	
ἐκνικᾶι	v3spoa---	ἐκνικᾶι	_6	
ἑκούσας	v-pppafa-	ἑκούσας	_6	
ἐκπέμψας	v-sapamn-	ἐκπέμπω	_7	
ἐκπεφεύγασιν	v3pria---	ἐκπεφεύγασιν	_9	
ἐκπλήσας	v-sapamn-	ἐκπλέω	_7	
ἐκπνεούσας	v-pppafa-	ἐκπνεούσας	_9	
ἐκπνεύσας	v-sapamn-	ἐκπνεύω	_8	
ἐκπράξας	v-sapamn-	ἐκπράκω	_7	
ἐκπράξας	v-sapamn-	ἐκπράσσω	_7	
ἐκτελευτήσας	v-sapamn-	ἐκτελευτάω	_11	
ἐκΤροίας	a-p---fa-	ἐκΤροίας		
ἐκτροπάς	n-p---fa-	ἐκτροπή	_7	
ἐκφύς	v-sapamn-	ἐκφύομαι	_4	
ἐκφὺς	v-sapamn-	ἐκφύομαι	_4	
ἐκφύς	v-sapamn-	ἐκφύς	_4	
ἐκφυσᾷ	v-sapafn-	ἐκφυσᾷ	_6	
ἐκχέας	v-sapamn-	ἐκχέω	_5	
ἔλα	v2spma---	ἔλα	_3	
ἐλαίας	n-s---fg-	ἐλαί	_3	
ἐλαίας	n-s---fg-	ἐλαία	_3	
ἐλαίας	n-p---fa-	ἐλαία	_3	
ἐλατᾶν	n-s---fa-	ἐλατᾶν	_5	
ἐλάτας	n-p---fa-	ἐλάτη	_5	
ἐλέγξας	v-sapamn-	ἐλέγγω	_6	
ἑλένας	n-s---fg-	ἑλένα	_5	
Ἑλένας	n-s---fg-	Ἑλένη		
ἐλευθερίᾳ	n-s---fd-	ἐλευθερία	_9	
ἐλευθερίας	n-s---fg-	ἐλευθερία	_9	
ἐλευθέρας	a-p---fa-	ἐλεύθερος	_8	
ἐλευθερώσας	v-sapamn-	ἐλευθερόω	_10	
Ἐλευσινίας	a-s---fg-	Ἐλευσινῖος		
ἑλίξας	v-sapamn-	ἑλίσσω	_5	
Ἑλλανίας	n-s---fg-	Ἑλλανίη	_7	
Ἑλλανίας	a-p---fa-	Ἑλλανῖος	_7	
Ἑλληνίδας	a-p---fa-	ἑλληνίς		
Ἑλλανίας	a-s---fg-	Ἑλλίναος	_7	
ἐλπίδας	n-p---fa-	ἐλπίς	_6	
ἐμβριμωμένας	v-prpefa-	ἐμβριμωμένας	_11	
ἐμάς	a-p---fa-	ἐμός	_3	
ἐμάς	a-p---fa-	ἐμός	_3	
ἐμάς	a-s---fg-	ἐμός	_3	
ἐμὰς	a-p---fa-	ἐμός	_3	
ἐμὰς	a-s---fg-	ἐμός	_3	
ἐμπολήσας	v-sapamn-	ἐμπολάω	_8	
ἐμπρήσας	v-sapamn-	ἐμπρέω	_7	
ἐναλίας	a-s---fg-	ἐναλία	_6	
ἐναλίας	a-s---fg-	ἐναλίος	_6	
ἐναλίας	a-s---fg-	ἐναλῖος	_6	
ἐναρμόσας	v-sapamn-	ἐναρμόζω	_8	
ἐνδείκνυσιν	v3ppia---	ἐνδείκνυσιν	_8	
ἐνδυναστεύσας	v-sapamn-	ἐνδυναστεύω	_12	
ἐνδύς	v-sapamn-	ἐνδύω	_4	
ἐνζεύξας	v-sapamn-	ἐνζεύγνυμι	_7	
ἐνθουσιᾶις	n-p---fd-	ἐνθουσιᾶ	_8	
ἐννυχιᾶν	a-s---fa-	ἐννυχιᾶ	_7	
Ἐνοδίας	n-s---fg-	Ἐνοδίη		
ἐνσείσας	v-sapamn-	ἐνσείω	_7	
ἐξάρας	v-sapamn-	ἐξαίρω	_5	
ἐξακοντίσας	v-sapamn-	ἐξακοντίω	_10	
ἐξαλλάξας	v-sapamn-	ἐξαλλάσσω	_8	
ἐξαλύξας	v-sapamn-	ἐξαλύγνυμι	_7	
ἐξαμᾷ	v3saia---	ἐξαμάω	_5	
ἐξαμείψας	v-sapamn-	ἐξαμείπτω	_8	
ἐξαναρπάσας	v-sapamn-	ἐξαναρπάζω	_10	
ἐξανασπάσας	v-sapamn-	ἐξανασπάζω	_10	
ἐξαναστήσας	v-sapamn-	ἐξανίστημι	_10	
ἐξανύσας	v-sapamn-	ἐξανύω	_7	
ἐξάψας	v-sapamn-	ἐξάπτω	_5	
ἐξαρκέσας	v-sapamn-	ἐξαρκέω	_8	
ἐξαρπάσας	v-sapamn-	ἐξαρπάω	_8	
ἐξαύδα	v2spma---	ἐξαύδα	_3	
ἐξαυδωμένας	v-pppefa-	ἐξαυδάομαι	_3	
ἐξαύδα	v2spma---	ἐξαυδάω	_3	
ἐξέβας	v-sapamn-	ἐξέβας	_5	
ἐξεβρυχᾶτ’	v3plie---	ἐξεβρυχᾶτ	_8	
ἐξερευνήσας	v-sapamn-	ἐξερευνήζω	_10	
ἐξερευνήσας	v-sapamn-	ἐξερευνήω	_10	
ἐξερημώσας	v-sapamn-	ἐξερημόω	_9	
ἐξημερώσας	v-sapamn-	ἐξημερόω	_9	
ἐξηρτυμένας	v-prpefa-	ἐξηρτυμένας	_10	
ἐξιᾶσι	v3ppia---	ἐξιᾶμι	_4	
ἐξιστορήσας	v-sapamn-	ἐξιστορέω	_10	
ἐξορίνας	v-sapamn-	ἐξορίνω	_7	
ἐξορμωμένας	v-pppefa-	ἐξορμωμένας	_10	
ἐξωινωμένας	v-pppefa-	ἐξωινωμένας	_10	
ἐξώρμα	v3siia---	ἐξώρμα	_6	
ἑορτάς	n-p---fa-	ἑορτή	_5	
ἑορτάς	n-p---fa-	ἑορτή	_5	
ἑορτὰς	n-p---fa-	ἑορτή	_5	
ἐπαινέσας	v-sapamn-	ἐπαινέω	_3	
ἐπάρας	v-sapamn-	ἐπαίρω	_5	
ἐπαιτιᾷ	v2spie---	ἐπαιτιᾷ	_3	
ἐπαιτιᾷ	v2spie---	ἐπαιτιάομαι	_3	
ἐπακτίᾳ	a-s---fd-	ἐπακτίᾳς	_7	
ἐπαξιώσας	v-sapamn-	ἐπαξιόω	_8	
ἐπέβα	v3siia---	ἐπέβα	_5	
ἐπεικάσας	v-sapamn-	ἐπεικάσας	_8	
ἐπεμβάς	v-sapamn-	ἐπεμβαίνω	_6	
ἐπεμβὰς	v-sapamn-	ἐπεμβαίνω	_6	
ἐπεξιακχάσας	v-sapamn-	ἐπεξιακχάσας	_11	
ἐπερειδομένας	v-prpefa-	ἐπερειδομένας	_12	
ἐπιστάς	v-sapamn-	ἐπι	_6	
ἐπιστὰς	v-sapamn-	ἐπι	_6	
ἐπιβᾶσαι	v--ana---	ἐπιβᾶθω	_5	
ἐπιβάς	v-sapamn-	ἐπιβαίνω	_5	
ἐπιβὰς	v-sapamn-	ἐπιβαίνω	_5	
ἐπιβᾶσ’	v-sapafn-	ἐπιβᾶσ	_5	
ἐπίβα	v2spma---	ἐπιβάω	_5	
ἐπιγλωσσᾷ	a-s---fn-	ἐπιγλωσσάω	_9	
ἐπιδρομάς	n-p---fa-	ἐπιδρομή	_8	
ἐπιδρομάς	n-p---fa-	ἐπιδρομή	_8	
ἐπιδρομὰς	n-p---fa-	ἐπιδρομή	_8	
ἐπιθύσας	v-sapamn-	ἐπιθύζω	_7	
ἐπικεκλιμένας	v-prpefa-	ἐπικεκλιμένας	_12	
ἐπικρᾶναι	v--ana---	ἐπικρᾶναι	_6	
ἐπιλαβάς	n-p---fa-	ἐπιλαβή	_7	
ἐπιλαβὰς	n-p---fa-	ἐπιλαβή	_7	
ἐπινωμᾷ	v1spia---	ἐπινωμᾷ	_7	
ἐπινωμᾷ	n-s---nn-	ἐπινωμᾷ	_7	
ἐπινωμᾶν	v1saom---	ἐπινωμᾶν	_7	
ἐπενώμα	v3siia---	ἐπινωμάω	_7	
ἐπινωτίσας	v-sapamn-	ἐπινωτίδω	_9	
ἐπιπλοίας	n-p---fa-	ἐπιπλοίη	_8	
ἐπιπνεύσας	v-sapamn-	ἐπιπνεύω	_9	
ἐπιπνοίας	n-s---fg-	ἐπιπνοία	_8	
ἐπιρροάς	a-p---fa-	ἐπιρροάς	_7	
ἐπισπάσας	v-sapamn-	ἐπισπάω	_8	
ἐπίστᾳ	v2spme---	ἐπίστᾳ	_6	
ἐπίστᾳ	v2spie---	ἐπίστᾳ	_6	
ἐπιστᾶσαι	v2spie---	ἐπιστᾶμαι	_6	
ἐπιστολάς	n-p---fa-	ἐπιστολάς	_8	
ἐπιστολάς	n-p---fa-	ἐπιστολή	_8	
ἐπιστολάς	n-p---fa-	ἐπιστολή	_8	
ἐπιστολὰς	n-p---fa-	ἐπιστολή	_8	
ἐπιστρέψας	v-sapamn-	ἐπιστρέφω	_9	
ἐπιστροφάς	n-p---fa-	ἐπιστροφή	_9	
ἐπιστροφάς	a-p---fa-	ἐπιστροφή	_9	
ἐπιστροφὰς	a-p---fa-	ἐπιστροφή	_9	
ἐπιστρωφᾶι	v2spie---	ἐπιστρωφᾶι	_9	
ἐπισφάξας	v-sapamn-	ἐπισφάσσω	_8	
ἐπιχαλᾷς	v2spsa---	ἐπιχαλάω	_7	
ἐποικτίρας	v-sapamn-	ἐποικτείρω	_9	
ἐπόμνυς	v-sppamn-	ἐπόμνυς	_6	
ἐποπτεύσας	v-sapamn-	ἐποπτεύω	_9	
ἐπτοημένας	v-prpefa-	ἐπτοημένας	_9	
ἐπῳδάς	n-p---fa-	ἐπῳδή	_5	
ἐπῳδὰς	n-p---fa-	ἐπῳδή	_5	
ἐπωμίδας	n-p---fa-	ἐπωμίς	_7	
ἐπωνυμίᾳ	n-s---fd-	ἐπωνυμία	_8	
ἐπωπάς	n-p---fa-	ἐπωπή	_5	
ἐπωφελήσας	v-sapamn-	ἐπωφελάω	_9	
ἔρα	v2spma---	ἔρα	_3	
ἐραστάς	a-p---fa-	ἐραστός	_6	
ἐραστὰς	a-p---fa-	ἐραστός	_6	
ἔρξας	v-sapamn-	ἔρδω	_4	
ἐρείσας	v-sapamn-	ἐρείδω	_6	
ἐρευνάσας	v-sapamn-	ἐρευνάω	_8	
Ἐρεχθεϊδᾶν	n-p---mg-	Ἐρεχθεῖδαϊ		
ἐρήμας	a-p---fa-	ἐρήμας	_5	
ἐρημίας	n-s---fg-	ἐρημία	_6	
ἐρημίας	n-s---fg-	ἐρημίας	_6	
ἐρημώσας	v-sapamn-	ἐρημώζω	_7	
Ἐριβοίᾳ	a-s---fv-	Ἐριβοίᾳ		
Ἐρινῦς	n-s---fn-	ἐρινύς		
Ἐρινῦς	n-p---fa-	ἐρινύς		
Ἐρινῦς	n-s---fn-	Ἐρινῦς		
ἐρίπνας	a-p---fa-	ἐρίπνας	_6	
ἐρίπνας	a-p---fa-	ἐρίπνη	_6	
ἑρκείας	a-p---fa-	ἑρκεῖος	_6	
Ἑρμιόναν	n-s---ma-	Ἑρμιόνης		
Ἐρυθείας	n-s---fg-	Ἐρυθεία		
Ἐρυθράς	a-p---fa-	Ἐρυθρός		
ἐρυμνᾶς	p-s---fa-	ἐρυμι	_6	
ἐρωτήσας	v-sapamn-	ἐρωτάω	_7	
ἐσβολάς	n-p---fa-	ἐσβολή	_6	
ἐσβολὰς	n-p---fa-	ἐσβολή	_6	
ἐσθλάς	a-p---fa-	ἐσθλός	_5	
ἐσθλὰς	a-p---fa-	ἐσθλός	_5	
ἑστίας	n-s---fg-	ἑστία	_5	
Ἑστίας	n-s---fg-	Ἑστία		
ἑστίᾳ	n-d---fn-	ἑστίᾳ	_5	
ἑστίας	n-s---fg-	ἑστῖα	_5	
ἑστιᾶι	v3spsa---	ἑστιᾶι	_5	
ἑστίας	n-s---fg-	ἑστίας	_5	
ἑστίας	n-s---fg-	ἑστίη	_5	
ἐστολισμένας	v-prpefa-	ἐστολισμένας	_11	
ἐσφάδᾳζε	v3siia---	ἐσφάδᾳζε	_6	
ἐσχάρᾳ	n-s---fd-	ἐσχάρη	_6	
ἐσχάρας	n-p---fa-	ἐσχάρη	_6	
ἐσχάρας	n-s---fg-	ἐσχάρη	_6	
ἐσχάτας	a-p---fa-	ἔσχατος	_6	
ἐσχάτας	a-s---fg-	ἔσχατος	_6	
ἑταιρείας	n-s---fg-	ἑταιρεία	_3	
ἑταιρίας	n-s---fg-	ἑταιρία	_3	
ἑτέρας	a-p---fa-	ἕτερος	_5	
ἐτιμᾶτ’	v2piia---	ἐτιμᾶτ	_5	
ἑτοιμάσας	v-sapamn-	ἑτοιμάζω	_8	
ἐτείας	a-s---fg-	ἐτύς	_5	
Εὐβοίας	n-s---fg-	εὔβοια		
εὐβουλίας	n-s---fg-	εὐβουλία	_8	
Εὐβουλίας	n-s---fg-	εὐβουλία		
εὐβουλίᾳ	n-s---fn-	εὐβουλίᾳ	_8	
εὐγενείας	n-s---fg-	εὐγενεία	_8	
εὐγενίας	n-s---fg-	εὐγενί	_7	
εὐγενίας	n-s---fg-	εὐγενία	_7	
εὐδαιμονίας	n-s---fg-	εὐδαιμονία	_4	
εὐδίᾳ	n-s---fd-	εὐδία	_5	
εὐδοξίας	n-s---fg-	εὐδοξία	_7	
εὐεπείας	n-s---fg-	εὐέπεια	_7	
εὐεργέταν	n-s---ma-	εὐεργέτης	_8	
εὐθυντηρίας	n-s---fg-	εὐθυντηρία	_10	
εὐκλεεστάτας	a-s---fgs	εὐκλεεστάτας	_11	
εὐκλείας	n-s---fg-	εὔκλεια	_7	
εὐκοσμίας	n-p---fa-	εὐκοσμίη	_8	
εὐλογίας	n-s---fg-	εὐλογία	_7	
εὐλύρας	n-s---mn-	εὐλύρης	_6	
εὐμαρείᾳ	n-s---fd-	εὐμαρεία	_8	
εὐμενείας	n-p---fa-	εὐμένεια	_8	
Εὐμενίδας	n-p---fa-	Εὐμενίδας		
Εὐμολπιδᾶν	a-s---fa-	Εὐμολπιδᾶν		
εὐναίας	a-p---fa-	εὐναῖος	_4	
εὐνᾶιπόσιν	n-p---md-	εὐνᾶιπών	_4	
εὐνάς	n-p---fa-	εὐνάς	_4	
εὐνάς	n-p---fa-	εὐνή	_4	
εὐνάς	n-p---fa-	εὐνή	_4	
εὐνὰς	n-p---fa-	εὐνή	_4	
εὐνοίας	n-p---fa-	εὔνοια	_6	
εὐνομίᾳ	n-p---na-	εὐνομίᾳ	_7	
εὐπατριδᾶν	n-s---ma-	εὐπατριδᾶν	_9	
εὐπατριδᾶν	n-s---ma-	εὐπατριδᾶς	_9	
εὐπατρίδαν	n-s---ma-	εὐπατρίδας	_9	
εὐπατρίδαν	a-s---ma-	εὐπατρίδας	_9	
εὐπετείας	n-s---fg-	εὐπέτεια	_8	
εὐπλοίας	n-p---fa-	εὔπλοια	_7	
εὐπραξίᾳ	n-s---fd-	εὐπραξία	_8	
εὐπραξίας	n-s---fg-	εὐπραξία	_8	
εὐπραξίας	n-s---fg-	εὔπραξια	_8	
Εὐρώπαν	n-s---ma-	Εὐρώπας		
Εὐρωπίας	n-s---fg-	Εὐρωπία		
Εὐρώτα	n-s---mg-	Εὐρώς		
Εὐρώταν	n-s---ma-	Εὐρώτας		
Εὐρώπας	a-p---fa-	Εὐρώψ		
Εὐρώτα	n-s---mg-	Εὐς		
εὐσεβείας	n-s---fg-	εὐσέβεια	_8	
εὐσεβίας	n-s---fg-	εὐσεβίας	_7	
εὐσοίας	n-s---fg-	εὔσοια	_6	
εὐσπλαγχνίας	n-p---fa-	εὐσπλαγχνίη	_11	
εὐτεκνίας	n-s---fg-	εὐτεκνία	_8	
εὐτυχήσας	v-sapamn-	εὐτυχέω	_8	
εὐτυχίας	n-s---fg-	εὐτυχία	_7	
εὐφαρέτραν	n-s---ma-	εὐφαρέτρης	_9	
εὐφρόνας	a-p---fa-	εὐφρόνας	_7	
εὐχά	v3siia---	εὐχάμι	_4	
εὐχάς	n-p---fa-	εὐχή	_4	
εὐχάς	n-p---fa-	εὐχή	_4	
εὐχὰς	n-p---fa-	εὐχή	_4	
εὐψυχίας	n-p---fa-	εὐψυχία	_7	
εὐψυχίας	n-s---fg-	εὐψυχία	_7	
εὐψυχίας	n-s---fg-	εὔψυχια	_7	
ἔφα	v3siia---	ἔφα	_3	
ἐφετμάς	n-p---fa-	ἐφετμάς	_6	
ἐφετμάς	n-p---fa-	ἐφετμή	_6	
ἐφετμὰς	n-p---fa-	ἐφετμή	_6	
ἐφημοσύνᾳ	n-p---na-	ἐφημοσύνᾳ	_9	
ἐφολκίδας	n-p---fa-	ἐφολκίς	_8	
ἐχθήρας	v-sapamn-	ἐχθεήρω	_6	
ἔχθρας	n-p---fa-	ἔχθρα	_5	
ἔχθρας	n-s---fg-	ἔχθρη	_5	
ἐχίδνας	n-p---fa-	ἐχίδνη	_6	
Ἐχίδνας	n-s---fg-	Ἐχίδνη		
Ἐχίνας	a-p---fa-	Ἐχίνας		
ἐχούσας	v-pppafa-	ἐχούσας	_6	
ἐχούσας	v-pppafa-	ἔχω	_6	
ζεύξας	v-sapamn-	ζεύγνυμι	_5	
ζημίας	n-s---fg-	ζημία	_5	
ζόας	n-s---fg-	ζόη	_3	
ζόας	n-p---fa-	ζόη	_3	
ζώνας	n-p---fa-	ζώνη	_4	
ζώσας	v-pppafa-	ζώσας	_4	
ζώσας	v-pppafa-	ζώω	_4	
ἥβας	v-sapamn-	ἥβη	_3	
ἥβας	n-p---fa-	ἥβη	_3	
ἥβας	n-s---fg-	ἥβη	_3	
Ἥβας	n-p---fa-	Ἥβη		
ἡδείας	a-s---fg-	ἡδεῖος	_5	
ἡδομένα	v-dppefn-	ἡδομένα	_7	
ἡδονάς	n-p---fa-	ἡδονή	_5	
ἡδονάς	n-p---fa-	ἡδονή	_5	
ἡδονὰς	n-p---fa-	ἡδονή	_5	
Ἠλέκτρας	n-s---fg-	Ἠλέκτρα		
ἁμερᾶν	n-s---fa-	ἡμερᾶ	_5	
ἡμέρας	n-p---fa-	ἡμέρα	_5	
ἡμέρας	n-s---fg-	ἡμέρα	_5	
ἡμετέρας	a-s---fg-	ἡμέτερος	_7	
ἡμετέρας	a-p---fa-	ἡμέτερος	_7	
ἡμιλλᾶτο	a-p---na-	ἡμιλλᾶτο	_6	
ἡνίας	n-s---fg-	ἡνία	_4	
ἡνίας	n-p---fa-	ἡνία	_4	
ἠπάτα	v3siia---	ἠπάτα	_5	
Ἥρας	n-s---fg-	ἥρα		
Ἥρας	n-p---fa-	ἥρα		
Ἡρακλείας	a-s---fg-	ἡράκλειος	_8	
ἠρεμίας	n-s---fg-	ἠρεμίας	_6	
ᾑρήκασιν	v3pria---	ᾑρήκω	_5	
ἠρημωμένας	v-prpefa-	ἠρημωμένας	_9	
Ἥρα	n-s---mv-	Ἥρης		
ἡσυχίας	n-s---fg-	ἡσυχία	_6	
ηὔδα	v3siia---	ηὔδα	_4	
Ηὔδας	v2siia---	Ηὔδας		
θαλάμας	n-p---fa-	θαλάμας	_6	
θαλάσσας	n-p---fa-	θαλάσσα	_7	
θαλάσσας	n-s---fg-	θαλάσσα	_7	
θαλάσσας	n-s---fg-	θαλάσσας	_7	
θαλασσίας	a-s---fg-	θαλασσῖος	_8	
θαλασσίας	a-p---fa-	θαλασσῖος	_8	
θαλεράς	a-p---fa-	θαλερός	_6	
θαλερὰς	a-p---fa-	θαλερός	_6	
θανούσας	v-sapafg-	θανούθω	_7	
θάψας	v-sapamn-	θάπτω	_4	
θαρσήσας	v-sapamn-	θαρσέω	_7	
θἀτέρᾳ	a-p---nac	θἀτέρᾳ	_6	
θαυμάσας	v-sapamn-	θαυμάζω	_5	
θαυμάσας	v-sapamn-	θαυμάω	_5	
θεά	n-d---fn-	θεά	_3	
θεάς	n-s---fg-	θεά	_3	
θεάς	n-s---fg-	θεά	_3	
θεάς	n-p---fa-	θεά	_3	
θεὰς	n-s---fg-	θεά	_3	
θεὰς	n-p---fa-	θεά	_3	
θέας	n-s---fg-	θέα	_3	
θεάς	n-s---fg-	θεάς	_3	
θεάς	n-s---fg-	θεάς	_3	
θεάς	n-p---fa-	θεάς	_3	
θεὰς	n-s---fg-	θεὰς	_3	
θείας	n-s---fg-	θεία	_4	
θείας	a-s---fg-	θεῖος	_4	
θέλξας	v-sapamn-	θέλ	_5	
θελήσας	v-sapamn-	θελάω	_6	
θελούσας	v-pppafa-	θέλω	_7	
θεοσεβεστάτας	a-p---fa-	θεοσεβεστάτας	_12	
θεραπνᾶν	n-s---fa-	θεραπνᾶ	_7	
θερίσας	v-sapamn-	θερίσας	_6	
θερμάς	a-p---fa-	θερμός	_5	
θερμὰς	a-p---fa-	θερμός	_5	
θεσπεσίας	a-p---fa-	θεσπέσιος	_8	
θεσπίσας	v-sapamn-	θεσπίσας	_7	
Θεσσαλίας	n-s---fg-	Θεσσαλία	_8	
Θεστιάς	n-s---fg-	Θεστιὰ		
Θεστιὰς	n-s---fg-	Θεστιὰ		
θεωρίας	n-s---fg-	θεωρία	_6	
Θήβας	v-sapamn-	Θή		
Θήβας	n-p---fa-	θῆβαι		
Θήβας	n-s---fg-	θῆβαι		
Θηβαΐας	a-p---fa-	θηβαῖος	_6	
Θηβαίας	a-s---fg-	Θηβαῖος		
Θήβας	n-p---fa-	Θήβας		
Θήβας	n-s---fg-	θήβη		
θηγάνας	n-p---fa-	θηγάνη	_6	
θήκας	n-p---fa-	θήκη	_4	
θηλείας	a-s---fg-	θῆλυς	_6	
θηλείας	a-p---fa-	θῆλυς	_6	
θήρας	n-p---fa-	θήρας	_4	
Θησείδα	n-s---mg-	Θησείδα		
θιασώταν	n-s---ma-	θιασώτης	_7	
θιγάς	v-sapamn-	θιγάς	_4	
θιγὰς	v-sapamn-	θιγὰς	_4	
θνατᾶς	a-p---fa-	θνατᾶς	_5	
Θόας	a-p---fa-	θόας		
Θόας	a-s---fg-	θόας		
θοίνας	n-p---fa-	θοίνη	_5	
θοάς	a-p---fa-	θοός	_3	
θοὰς	a-p---fa-	θοός	_3	
θραύσας	v-sapamn-	θραύω	_3	
θρεομένας	v-sppefg-	θρεομένας	_8	
θρέψας	v-sapamn-	θρέπτω	_5	
θρεομένας	v-sppefg-	θρέω	_8	
Θρηικίας	a-p---fa-	Θρηικίας		
Θρηικίας	a-s---fg-	Θρηικῖος		
θραυομένας	v-sppefg-	θρήυω	_3	
τρίχας	n-p---fa-	θρίξ	_5	
θυγατέρας	n-p---fa-	θυγάτηρ	_8	
θυιάς	n-s---fg-	θυιὰ	_4	
θυιὰς	n-s---fg-	θυιὰ	_4	
θυιάς	a-p---fa-	θυιάς	_4	
θυιάς	a-s---fg-	θυιάς	_4	
θυιὰς	a-p---fa-	θυιὰς	_4	
θυιὰς	a-s---fg-	θυιὰς	_4	
θυμέλας	n-p---fa-	θυμέλας	_6	
θυμέλας	n-p---fa-	θυμέλη	_6	
θύρας	n-s---fg-	θύρα	_4	
θύρας	n-p---fa-	θύρα	_4	
θυραίᾳ	a-p---nn-	θυραίᾳ	_4	
θυραίας	a-s---fg-	θυραῖος	_4	
θυσίας	n-p---fa-	θυσία	_5	
θυσίας	n-s---fg-	θυσία	_5	
θυστάδας	a-p---fa-	θυστάς	_7	
θύσας	v-sapamn-	θύω	_4	
Ἴδας	n-s---fg-	Ἴ		
Ἰᾶσον	v2sama---	Ἰᾶσον		
ἰατορίας	n-s---mn-	ἰατορίας	_7	
ἰαχᾶι	n-p---fn-	ἰαχᾶι	_4	
ἰαχᾶς	n-p---fa-	ἰαχᾶς	_4	
Ἰδαιᾶν	a-s---fa-	Ἰδαιᾶ		
Ἰδαιᾶν	a-s---fa-	Ἰδαιᾶν		
Ἰδαίας	a-s---fg-	̓ἰδαῖος		
Ἴδας	n-p---fa-	Ἴδη		
ἰδίᾳ	a-s---fd-	ἴδιος	_4	
ἰδίας	a-s---fg-	ἴδιος	_4	
ἰδίας	a-p---fa-	ἴδιος	_4	
ἱδρύσας	v-sapamn-	ἱδρύζω	_6	
ἱδρυμένας	v-prpefa-	ἱδρυμένας	_8	
ἱδρῦσθαι	v--rne---	ἱδρύω	_4	
ἱδρῦσαι	v--ana---	ἱδρῦω	_4	
ἱερέαν	n-s---ma-	ἱερέης	_5	
ἱεράς	a-p---fa-	ἱερός	_4	
ἱερὰς	a-p---fa-	ἱερός	_4	
ἱερᾶς	a-p---fa-	ἱερός	_4	
ἱερᾶς	a-s---fg-	ἱερός	_4	
ἰηλεμιστρίας	n-s---fg-	ἰηλεμιστρία	_11	
ἱκεσίας	n-p---fa-	ἱκεσία	_6	
ἱκεσία	n-d---fn-	ἱκέσιος	_6	
ἱκετᾶν	n-s---fa-	ἱκετᾶ	_5	
ἱκέταν	n-s---ma-	ἱκέτης	_5	
ἱκτηρίας	n-s---fg-	ἱκτηρία	_7	
Ἰλιάδας	n-p---fa-	Ἰλιάς	_6	
Ἰλιάς	n-s---fg-	Ἰλιάς		
Ἰλιὰς	n-s---fg-	Ἰλιάς		
ἱμᾶσιν	n-p---md-	ἱμάς	_3	
ἱμᾶσι	n-p---md-	ἱμᾶσι	_3	
Ἰναχείας	n-s---fg-	Ἰναχείη	_7	
Ἰνδάς	n-p---fa-	Ἰνδάι		
ἶνινὑμνῆσαι	n-s---fa-	ἶνινὑμνῆσαι	_1	
Ἰοκάστας	n-p---fa-	Ἰοκάστη	_7	
ἱππευτάν	n-s---ma-	ἱππευτάν	_7	
ἱππίαν	n-s---ma-	ἱππίης	_5	
ἱππικάς	a-p---fa-	ἱππικός	_6	
ἱππικὰς	a-p---fa-	ἱππικός	_6	
ἱπποβάτας	n-s---mn-	ἱπποβάτας	_8	
ἱπποβότα	n-s---mg-	ἱπποβότα	_8	
ἱππονώμας	n-s---mn-	ἱππονώμας	_8	
ἱππείας	a-p---fa-	ἱππύς	_6	
Ἰσθμίας	a-s---fg-	ἴσθμιος		
Ἰσθμίας	a-p---fa-	ἴσθμιος		
ἴσας	a-p---fa-	ἴσος	_3	
ἰσώσας	v-sapamn-	ἰσόω	_5	
ἱστᾶσα	v-sppafn-	ἱστᾶσα	_4	
στάς	v-sapamn-	ἵστημι	_3	
Στάς	v-sapamn-	ἵστημι		
στὰς	v-sapamn-	ἵστημι	_3	
Στὰς	v-sapamn-	ἵστημι		
στήσας	v-sapamn-	ἵστημι	_5	
ἰσχῦον	v-sppana-	ἰσχύω	_4	
ἰχθῦς	n-p---ma-	ἰχθύς	_4	
Ἰωλκίας	n-s---fg-	Ἰωλκία		
Ἰωλκίας	a-s---fg-	Ἰωλκῖος		
ἰώμελέα	a-s---mv-	ἰώμελέα	_7	
κάββας	v-sapamn-	κάββης	_5	
κἀγορᾶς	n-p---fa-	κἀγορᾶ	_6	
κἀγορᾶς	a-s---mn-	κἀγορᾶς	_6	
Καδμειᾶν	a-s---fa-	Καδμειᾶν	_7	
Καδμείας	a-s---fg-	Καδμείας	_7	
Καδμείας	a-s---fg-	Καδμεῖος	_7	
Καδμείας	a-p---fa-	Καδμεῖος	_7	
καθαγνίσας	v-sapamn-	καθαγνίσας	_9	
καθαιμάξας	v-sapamn-	καθαιμάσσω	_7	
καθαρᾶν	a-s---fa-	καθαρᾶν	_6	
καθαρμόσας	v-sapamn-	καθαρμόζω	_9	
καθαράς	a-p---fa-	καθαρός	_6	
καθαρὰς	a-p---fa-	καθαρός	_6	
καθαρπάσας	v-sapamn-	καθαρπάζω	_9	
καθεστᾶσιν	v3ppia---	καθεστᾶμι	_7	
καταστάς	v-sapamn-	καθίστημι	_7	
καταστὰς	v-sapamn-	καθίστημι	_7	
καθορᾶν	v--pna---	καθοράω	_6	
καθυβρίσας	v-sapamn-	καθυβρίσας	_9	
καινάς	a-p---fa-	καινάς	_2	
καινάς	a-p---fa-	καινός	_2	
καινὰς	a-p---fa-	καινός	_2	
καιρίας	a-s---fg-	καιρίας	_2	
κακᾷ	a-p---na-	κακᾷ	_4	
Κακᾷ	a-p---na-	Κακᾷ	_4	
κακανδρίᾳ	n-s---fa-	κακανδρίᾳ	_9	
κἀκβολάς	n-p---fa-	κἀκβολή	_7	
κἀκβολὰς	n-p---fa-	κἀκβολή	_7	
κακάς	a-p---fa-	κακός	_4	
Κακάς	a-p---fa-	κακός	_4	
κακὰς	a-p---fa-	κακός	_4	
Κακὰς	a-p---fa-	κακός	_4	
κἀκούσας	v-sapamn-	κἀκούδω	_7	
κακουχίᾳ	n-s---fd-	κακουχίη	_8	
καλαμοεςσᾶν	n-p---fn-	καλαμος	_10	
καλλιβόας	n-s---mn-	καλλιβόας	_8	
καλλονᾶς	n-p---fa-	καλλονᾶς	_7	
καλλοσύνας	n-p---fa-	καλλοσύνη	_9	
καλλοσύνας	n-s---fg-	καλλοσύνη	_9	
καλάς	a-p---fa-	καλός	_4	
καλάς	a-p---fa-	καλός	_4	
καλὰς	a-p---fa-	καλός	_4	
καλλίστας	a-s---fgs	καλός	_8	
καλύπτρᾳ	n-p---na-	κάλυπτρα	_8	
καλύπτρας	n-p---fa-	καλύπτρη	_8	
καλύψας	v-sapamn-	καλύπτω	_6	
Κάλχας	n-s---mn-	κάλχας	_5	
κἀμάς	a-p---fa-	κἀμός	_4	
κἀμὰς	a-p---fa-	κἀμός	_4	
κάμψας	v-sapamn-	κάμπτω	_5	
κανᾶ	c--------	κανά	_4	
κανᾶ	n-p---na-	κανά	_4	
κανᾶ	a-p---na-	κανά	_4	
κἀνακωκύσας	v-sapamn-	κἀνακωκύζω	_10	
κἀνακωκύσας	v-sapamn-	κἀνακωκύω	_10	
κἀντιβάς	n-p---fa-	κἀντιβή	_7	
Καπανέα	v2spma---	Καπανέα	_7	
κἀπιβοᾶται	n-p---mn-	κἀπιβοᾶτης	_7	
κἀπιδαυρίας	a-s---fg-	κἀπιδαυρῖος	_6	
κἀπικουρίας	n-s---fg-	κἀπικουρῖα	_10	
κἀπικωκῦσαι	v--ana---	κἀπικωκῦω	_8	
κἀποβᾶσα	v-sapafn-	κἀποβαίνω	_6	
κἀπονοσφίσας	v-sapamn-	κἀπονοσφίζω	_11	
κάρᾳ	n-s---nd-	κάρα	_4	
κάρᾳ	n-s---na-	κάρα	_4	
κάρᾳ	u--------	κάρᾳ	_4	
καρβᾶνα	a-s---fa-	καρβάν	_5	
καρδίᾳ	n-s---fd-	καρδία	_6	
καρδίας	n-s---fg-	καρδία	_6	
καρῦξαι	v--ana---	καρῦζω	_4	
Καρυστίας	a-s---fg-	Καρυστία	_8	
καρφυράς	a-p---fa-	καρφυρός	_7	
καρφυρὰς	a-p---fa-	καρφυρός	_7	
κασιγνήτας	n-p---fa-	κασιγνήτης	_9	
Κασσάνδρας	n-s---fg-	Κασσάνδρα	_9	
Κασταλίας	n-p---fa-	κασταλία	_8	
Κασταλίας	n-s---fg-	κασταλία	_8	
καταβᾶσα	v-sapafn-	καταβᾶσα	_6	
κατᾶξαι	v--ana---	κατᾶγω	_4	
καταισχῦναι	v--pna---	καταισχύνω	_8	
κατάκρας	n-p---fa-	κατάκρη	_7	
κατάκτας	v-sapamn-	κατάκτας	_7	
κατακτάς	v-sapamn-	κατακτείνω	_7	
κατακτάς	v-sapamn-	κατακτείνω	_7	
κατακτὰς	v-sapamn-	κατακτείνω	_7	
κατακτείνας	v-sapamn-	κατακτείνω	_10	
καταλγήσας	v-sapamn-	καταλγέω	_9	
καταπαύσας	v-sapamn-	καταπαύω	_6	
κατάρας	n-p---fa-	κατάρα	_6	
καταρράψας	v-sapamn-	καταρράπτω	_9	
κατασκαφάς	n-p---fa-	κατασκαφή	_9	
κατασκαφάς	n-p---fa-	κατασκαφή	_9	
κατασκαφὰς	n-p---fa-	κατασκαφή	_9	
κατασπείρας	v-sapamn-	κατασπείρω	_10	
κατάστας	v-sapamn-	κατάστας	_7	
καταύδα	v2spma---	καταύδα	_4	
καταυχήσας	v-sapamn-	καταυχέω	_4	
καταφθίσας	v-sapamn-	καταφθίζω	_9	
καταφυγάς	n-p---fa-	καταφυγή	_8	
καταφυγὰς	n-p---fa-	καταφυγή	_8	
κατηναρισμένας	v-prpefa-	κατεναρίζω	_13	
κατερρώγασιν	v3pria---	κατερρώγασιν	_9	
κατεσβήκασιν	v3pria---	κατεσβήκασιν	_9	
καταστάς	v-sapamn-	κατίστημι	_7	
κατόπτας	n-p---fa-	κατόπτη	_7	
κατορθώσας	v-sapamn-	κατορθώζω	_9	
κατωικήκασιν	v3pria---	κατωικήκασιν	_9	
κἀφαγιστεύσας	v-sapamn-	κἀφαγιστεύω	_12	
κεδνάς	a-p---fa-	κεδνός	_5	
κεδνὰς	a-p---fa-	κεδνός	_5	
κείνας	a-p---fa-	κείνας	_5	
Κεκροπίας	n-p---fa-	Κεκροπῖα		
Κεκροπίας	n-p---fa-	Κεκροπίη		
κεκρυμμένας	v-prpefa-	κεκρυμμένας	_10	
κελαινώπαν	a-s---ma-	κελαινώπας	_4	
κελεύσας	v-sapamn-	κελεύω	_7	
κέλσας	v-sapamn-	κέλω	_5	
κενάς	a-p---fa-	κενάς	_4	
κενάς	a-p---fa-	κενός	_4	
κενάς	a-p---fa-	κενός	_4	
κενὰς	a-p---fa-	κενός	_4	
κενώσας	v-sapamn-	κενόω	_6	
κεραϊζομένας	v-pppefa-	κεραϊζομένας	_11	
κέρας	n-s---nn-	κέρας	_4	
κέρας	n-s---na-	κέρας	_4	
κεραυνίᾳ	a-s---fd-	κεραυνίᾳ	_4	
κεραυνίας	a-s---fg-	κεραυνίη	_4	
κεραυνίᾳ	a-s---fd-	κεραύνιος	_4	
κερκίδας	n-s---fg-	κερκίδα	_7	
Κερχνείας	n-s---fg-	Κερχνείη		
κεφαλά	n-d---fn-	κεφαλάς	_6	
κεφαλάς	n-p---fa-	κεφαλή	_6	
κεφαλὰς	n-p---fa-	κεφαλή	_6	
κεφαλᾶς	n-p---fa-	κεφαλή	_6	
κεχειρωμένας	v-prpefa-	κεχειρωμένας	_11	
κηδείας	n-s---fg-	κηδεία	_6	
κηδεύσας	v-sapamn-	κηδεύω	_7	
κηρύξας	v-sapamn-	κηρύσσω	_6	
κιθάρας	n-s---fg-	κιθάρα	_6	
κισσώσας	v-sapamn-	κισσόω	_7	
κλάδας	n-p---fa-	κλά	_5	
κλαγγᾷ	n-s---fd-	κλαγγή	_6	
κλεινάς	a-p---fa-	κλεινός	_6	
κλεινάς	a-p---fa-	κλεινός	_6	
κλεινὰς	a-p---fa-	κλεινός	_6	
κλέψας	v-sapamn-	κλέπτω	_5	
κλέψας	v-sapamn-	κλέφω	_5	
κληδόνας	n-p---fa-	κληδόνας	_7	
κληδόνας	n-p---fa-	κληδών	_7	
κλαιομένας	v-sppefg-	κλήιω	_3	
κλισίας	n-p---fa-	κλισία	_6	
κλισίας	n-s---fg-	κλισία	_6	
κλοπάς	n-p---fa-	κλοπή	_5	
κλοπὰς	n-p---fa-	κλοπή	_5	
κλυούσᾳ	v-sppafn-	κλυούσᾳ	_7	
Κλυταιμήστρᾳ	n-s---fd-	Κλυταιμήστρα		
Κλυταιμήστρας	n-s---fg-	Κλυταιμήστρα		
Κλυταιμήστρας	n-s---fg-	Κλυταιμήστρας		
Κλυταιμήστρας	n-s---fg-	Κλυταιμήστρη		
κλυτᾶς	a-s---fg-	κλυτός	_5	
κλωπικάς	a-p---fa-	κλωπικὰ	_7	
κλωπικὰς	a-p---fa-	κλωπικὰ	_7	
κνέφας	n-s---nn-	κνέφας	_5	
κνέφας	n-s---na-	κνέφας	_5	
κνισᾶν	v3paia---	κνισᾶν	_5	
κοίτας	a-s---fg-	κοί	_5	
κοίλας	a-p---fa-	κοῖλος	_5	
κοινάς	a-p---fa-	κοινός	_5	
κοινάς	a-p---fa-	κοινός	_5	
κοινάς	a-s---fg-	κοινός	_5	
κοινὰς	a-p---fa-	κοινός	_5	
κοινὰς	a-s---fg-	κοινός	_5	
κοινώσας	v-sapamn-	κοινόω	_7	
κοῖταιπατρίας	n-p---fa-	κοῖταιπατρία	_8	
κοίτας	n-p---fa-	κοίτη	_5	
κόμας	n-p---fa-	κόμη	_4	
κονίσας	v-sapamn-	κονίζω	_6	
κόρας	n-p---fa-	κόρας	_4	
κόρσας	v-sapamn-	κόρζω	_5	
κόρας	n-s---fg-	κόρη	_4	
κόρας	n-p---fa-	κόρη	_4	
κούρας	n-p---fa-	κόρη	_5	
Κόρας	n-s---fg-	Κόρη		
κόραν	n-s---ma-	κόρης	_4	
Κορινθίας	n-s---fg-	Κορινθία		
Κορινθίας	a-s---fg-	Κορινθία		
Κορινθίας	a-s---fg-	Κορινθῖος		
κορυφᾶς	n-p---fa-	κορυφᾶς	_6	
κορυφάς	n-p---fa-	κορυφή	_6	
κορυφὰς	n-p---fa-	κορυφή	_6	
κοσμήσας	v-sapamn-	κοσμέω	_7	
κούφας	a-p---fa-	κούφας	_5	
κουφίσας	v-sapamn-	κουφίζω	_7	
κραδίας	n-s---fg-	κραδία	_6	
κραδίᾳ	n-p---nn-	κραδίᾳ	_6	
κραταιᾶς	a-s---fg-	κραταιός	_5	
κρατήσας	v-sapamn-	κρατέω	_7	
κρήνας	n-p---fa-	κρήνη	_5	
Κρησίας	n-p---fa-	Κρησία		
Κρήσσας	n-p---fa-	Κρήσση		
κριμναμενᾶν	v-sapafa-	κριμναμενᾶν	_10	
κρίνας	v-sapamn-	κρίνω	_5	
Κρονίδαν	n-s---ma-	Κρονίδας		
Κρονίδας	n-s---mn-	Κρονίδας		
Κρονίδας	n-s---mn-	κρονίδης		
κρυπτᾷ	a-p---na-	κρυπτᾷ	_6	
κρυπτᾶι	a-p---fn-	κρυπτᾶι	_6	
κρύψας	v-sapamn-	κρύπτω	_5	
κτείνας	v-sapamn-	κτείνω	_6	
κτένας	n-p---fa-	κτένη	_5	
κτίσας	v-sapamn-	κτίζω	_5	
κτίσσας	v-sapamn-	κτίζω	_6	
κυανέας	a-p---fa-	κυανέ	_6	
κυανεᾶν	a-s---fa-	κυανεᾶν	_6	
κυανέας	a-s---fg-	κυανέας	_6	
κυανέας	a-p---fa-	κυανέος	_6	
Κυβέλας	n-p---fa-	Κυβέλη		
κυκάτω	v3spma---	κυκαίνω	_4	
Κυκλάδας	n-p---fa-	κυκλάδες	_7	
κυκλώσας	v-sapamn-	κυκλώζω	_7	
Κυκλωπιᾶν	a-s---fa-	Κυκλωπιᾶ		
Κυκλωπίας	a-s---fg-	Κυκλωπία		
Κυλλανίας	n-p---fg-	Κυλ	_8	
Κυλλάνας	n-s---fg-	κυλλήνη	_7	
κυναγίας	n-s---fg-	κυναγία	_7	
κυναγίᾳ	n-s---fd-	κυνηγία	_7	
Κυπρίας	n-p---fa-	Κυπρίας		
κυρήσας	v-sapamn-	κυρέω	_6	
κύρσας	v-sapamn-	κυρέω	_5	
κυρήσας	v-sapamn-	κυρήσας	_6	
Κυχρείας	a-p---fa-	Κυχρύς		
κύνας	n-p---fa-	κύων	_4	
κώπας	n-p---fa-	κώπας	_4	
κώπας	n-p---fa-	κώπη	_4	
Λαβδακιδᾶν	n-p---mg-	Λαβδακίδης	_9	
λαβάς	n-p---fa-	λαβή	_4	
λαβὰς	n-p---fa-	λαβή	_4	
λαγοδαίτας	n-p---fa-	λαγοδαίται	_6	
λαγόνας	n-p---fa-	λαγόνη	_6	
λάθρᾳ	d--------	λάθρῃ	_5	
Λάθρᾳ	d--------	λάθρῃ	_5	
λαΐνας	n-p---fa-	λαΐνη	_5	
λακτίσας	v-sapamn-	λακτίζω	_7	
λαμπάδας	n-p---fa-	λαμπάς	_7	
λάμπᾳ	n-s---fd-	λάμπᾳς	_5	
λαμπρᾶς	a-p---fa-	λαμπρός	_6	
λαμπρᾶς	a-s---fg-	λαμπρός	_6	
λαμπτηρουχίας	a-p---fa-	λαμπτηρουχίη	_12	
λάμψας	v-sapamn-	λάμψας	_5	
λαοδάμας	n-s---mn-	λαοδάμας	_7	
Λαρτιάδας	n-s---mn-	Λαρτιάδης	_8	
λατρείας	n-s---fg-	λατρεία	_7	
λατρείας	n-p---fa-	λατρεία	_7	
λεαίνας	n-s---fg-	λεαίνη	_3	
λέξας	v-sapamn-	λέγω	_4	
λείας	n-p---fa-	λεία	_4	
λείας	n-s---fg-	λεία	_4	
λειμωνίας	a-p---fa-	λειμωνῖος	_8	
λελειμμένα	v-drpefn-	λείπω	_10	
λέξας	v-sapamn-	λέξας	_4	
λεοντοφυᾶ	n-s---fa-	λεοντοφυᾶ	_9	
λεπαίας	n-p---fa-	λεπαίη	_4	
λέπας	a-p---fa-	λέπη	_4	
λέπας	n-p---fa-	λέπη	_4	
Λερναίας	a-s---fg-	λερναῖος		
Λέρνας	n-s---fg-	Λέρνη		
λέσχας	n-p---fa-	λέσχη	_5	
Λευκιππίδας	n-p---fa-	Λευκιππίδη		
Λευκοθέας	n-s---fg-	Λευκοθέη		
λευκολόφας	n-s---mn-	λευκολόφης	_9	
λευκάς	a-p---fa-	λευκός	_5	
λευκὰς	a-p---fa-	λευκός	_5	
λήξας	v-sapamn-	λήγω	_4	
Λήδας	n-p---fa-	Λήδαι		
Λήδαν	n-s---ma-	Λήδαν		
Λήδας	n-s---fg-	Λήδας		
Λήδας	n-p---fa-	Λήδη		
Λήδας	n-s---fg-	Λήδη		
Λήδας	n-s---fg-	Λής		
Λήδας	n-p---fa-	Λής		
Λίμνας	n-s---fg-	Λί		
λιβάς	n-s---mn-	λιβάς	_4	
λιβὰς	n-s---mn-	λιβὰς	_4	
Λιβυσσᾶν	v3paia---	Λιβυσσᾶν		
λιγείας	a-s---fg-	λιγεῖος	_6	
λιγυρᾷ	a-s---fd-	λιγυρός	_6	
λιθάς	n-p---fa-	λιθή	_4	
λιθὰς	n-p---fa-	λιθή	_4	
λίμνᾳ	n-s---fd-	λίμνη	_5	
λίμνας	n-p---fa-	λίμνη	_5	
Λίμνας	n-p---fa-	λίμνη		
λισσάς	n-s---fg-	λισσάς	_5	
λισσὰς	n-s---fg-	λισσὰς	_5	
λιτάς	n-p---fa-	λιτάς	_4	
λιτάς	n-p---fa-	λιτή	_4	
λιτάς	n-p---fa-	λιτή	_4	
λιτὰς	n-p---fa-	λιτή	_4	
Λίχαν	n-s---ma-	Λίχανς		
Λίχα	n-s---mv-	λίχας		
Λίχας	n-s---mn-	λίχας		
λόγχας	n-p---fa-	λόγχη	_5	
λόγχας	n-s---fg-	λόγχη	_5	
λοιβάς	n-p---fa-	λοιβά	_5	
λοιβὰς	n-p---fa-	λοιβά	_5	
λοιβάς	n-p---fa-	λοιβάς	_5	
λοιβὰς	n-p---fa-	λοιβὰς	_5	
λομένας	v-pppefa-	λομένας	_6	
Λοξία	n-s---mv-	Λοξία		
Λοξίᾳ	n-s---mg-	Λοξίᾳ		
Λοξίας	n-s---mn-	λοξίας		
Λοξία	n-s---mv-	Λοξίας		
Λοξίαν	n-s---ma-	Λοξίας		
Λοξίας	n-s---mn-	Λοξίας		
λοχαγέτας	n-p---fa-	λοχαγέτη	_8	
λοχαίας	n-p---fa-	λοχαίη	_4	
λοχείας	n-p---fa-	λοχεία	_6	
λοχιᾶν	a-s---fa-	λοχιᾶν	_5	
λυγαίας	a-s---fg-	λυγαῖος	_4	
λυγράς	a-p---fa-	λυγρός	_5	
λυγρᾶς	a-s---fg-	λυγρός	_5	
Λυδίας	n-s---fg-	Λυδία		
Λυκίας	n-s---fg-	λυκία		
λύμᾳ	n-s---na-	λύμᾳ	_4	
λύμας	n-p---fa-	λύμη	_4	
λύπᾳ	a-p---na-	λύπᾳ	_4	
λύπας	n-p---fa-	λύπας	_4	
λύπας	n-p---fa-	λύπη	_4	
λύρας	n-s---fg-	λύρα	_4	
λύσσας	n-s---fg-	λύσσα	_5	
λύσσας	n-p---fa-	λύσσα	_5	
Λύσσας	n-s---fg-	Λύσση		
λύσας	v-sapamn-	λύω	_4	
λώβας	n-p---fa-	λώβη	_4	
Μαίας	n-p---fa-	μαῖα		
Μαίας	n-s---fg-	μαῖα		
μαινάδας	n-p---fa-	μαινάδαι	_5	
μαινάδας	n-p---fa-	μαινάδας	_5	
μαινάδας	n-p---fa-	μαινάς	_5	
μαινάς	n-p---fa-	μαινάς	_2	
μαινάς	n-s---fg-	μαινάς	_2	
μαινὰς	n-p---fa-	μαινάς	_2	
μαινὰς	n-s---fg-	μαινάς	_2	
μακαριωτάτας	a-p---fa-	μακαρειός	_11	
μακαρίας	a-s---fg-	μακαρίας	_7	
μακαρίτας	n-s---mn-	μακαρίτης	_8	
μακρᾶι	a-p---fd-	μακρᾶι	_5	
μακράς	a-s---fg-	μακρός	_5	
Μακράς	a-p---fa-	μακρός	_5	
Μακράς	a-s---fg-	μακρός	_5	
μακρὰς	a-s---fg-	μακρός	_5	
Μακρὰς	a-p---fa-	μακρός	_5	
Μακρὰς	a-s---fg-	μακρός	_5	
μακρᾶς	a-p---fa-	μακρός	_5	
μακρᾶς	a-s---fg-	μακρός	_5	
μανιάς	n-s---fg-	μανιά	_5	
μανιᾶν	n-s---fa-	μανιᾶ	_5	
μανίᾳ	n-s---fd-	μανία	_5	
μανίας	n-s---fg-	μανία	_5	
μαντείας	n-s---fg-	μαντεία	_7	
μαντείας	n-p---fa-	μαντεία	_7	
μαντείᾳ	a-s---fd-	μαντεῖος	_7	
μαρᾶναι	v--ana---	μαρᾶναι	_4	
μάρψας	v-sapamn-	μάρπτω	_5	
Μασίστρας	n-s---mn-	Μασίστρας	_8	
ματᾴζει	v3spia---	ματᾴ	_4	
Ματᾶν	n-s---ma-	Ματᾶ	_4	
ματᾷ	n-p---na-	ματᾷ	_4	
ματᾷ	p-p---na-	ματᾷ	_4	
μάταν	n-s---ma-	μάτα	_4	
ματᾴζων	v-sppamn-	ματᾴζω	_4	
ματαίᾳ	a-s---fd-	ματαίᾳ	_4	
ματαίᾳ	a-s---fn-	ματαῖος	_4	
ματαίας	a-s---fg-	ματαῖος	_4	
ματᾶν	v--pna---	ματάω	_4	
ματέρας	n-p---fa-	ματέρη	_6	
μαχανᾷ	n-p---na-	μαχανᾷ	_6	
μάχᾳ	n-s---fd-	μάχη	_4	
μάχας	n-p---fa-	μάχη	_4	
μαχουμένα	v-dppefn-	μαχουμένα	_9	
Μεγαβάτα	n-s---mg-	Μεγαβάτης	_8	
μέγαν	a-s---ma-	μέγαν	_4	
Μεγάρας	n-s---fg-	Μεγάρη	_6	
μεγάλα	a-d---fn-	μέγας	_6	
μεγάλας	a-p---fa-	μέγας	_6	
μέγαν	a-s---ma-	μέγας	_4	
μέγας	a-s---mn-	μέγας	_4	
Μέγας	a-s---mn-	μέγας		
μεγίστας	a-p---fas	μέγας	_7	
μεγίστας	a-p---fa-	μέγας	_7	
μεγάλᾳ	a-p---na-	μέγᾳς	_6	
μεγίστᾳ	a-p---na-	μεγίστᾳ	_7	
μεταστάς	v-sapamn-	μεθίστημι	_7	
μεταστὰς	v-sapamn-	μεθίστημι	_7	
μέλας	a-s---mn-	μέλας	_4	
μελέας	a-p---fa-	μελέη	_5	
μελέας	a-s---fg-	μελέος	_5	
μελισσᾶν	n-s---fa-	μέλισσα	_7	
μελισσᾶν	n-p---fg-	μέλισσα	_7	
μελιςσᾶν	n-s---fa-	μελιςτον	_7	
μελλούσας	v-pppafa-	μέλλω	_8	
μελωιδίας	n-s---fg-	μελωιδεία	_8	
Μενέλας	n-s---mn-	Μενέλας		
Μενέλα	n-s---mg-	Μενέλης		
μείνας	v-sapamn-	μένω	_5	
μερίμνας	n-p---fa-	μέριμνα	_7	
μερίμνας	n-s---fg-	μέριμνα	_7	
μέσας	a-p---fa-	μέσος	_4	
μεταβάς	v-sapamn-	μεταβαίνω	_6	
μεταβὰς	v-sapamn-	μεταβαίνω	_6	
μεταβολάς	n-p---fa-	μεταβολή	_8	
μεταβολάς	n-p---fa-	μεταβολή	_8	
μεταβολὰς	n-p---fa-	μεταβολή	_8	
μεταιτίᾳ	a-s---fd-	μεταιτία	_4	
μεταλλαγᾷ	v1sria---	μεταλλαγᾷ	_9	
μεταναστάς	v-sapamn-	μεταναστής	_9	
μετασπᾶν	v--pna---	μετασπάω	_7	
μεταστάς	v-sapamn-	μετίστημι	_7	
μεταστὰς	v-sapamn-	μετίστημι	_7	
μετοικίας	n-s---fg-	μετοικία	_8	
μετρίας	a-s---fg-	μετρῖος	_6	
Μηλιᾶ	n-p---na-	Μηλιᾶ		
μηλονόμας	n-p---fa-	μηλονόμη	_8	
μηνίσας	v-sapamn-	μηνίω	_6	
μηνύσας	v-sapamn-	μηνύω	_6	
μητέρας	n-p---fa-	μήτηρ	_6	
μητραλοίαν	n-s---ma-	μητραλοίας	_9	
μητρυιάς	n-p---fa-	μητρυιάς	_7	
μητρυιὰς	n-p---fa-	μητρυιὰς	_7	
μηχανάς	n-p---fa-	μηχανά	_6	
μηχανᾶι	v2spie---	μηχανᾶι	_6	
μηχανᾶν	v--pna---	μηχανάομαι	_6	
μηχανᾶσθαι	v--pne---	μηχανάομαι	_6	
μηχανάς	n-p---fa-	μηχανάς	_6	
μηχανάς	n-p---fa-	μηχανή	_6	
μηχανάς	n-p---fa-	μηχανή	_6	
μηχανὰς	n-p---fa-	μηχανή	_6	
μιᾶι	a-s---fd-	μιᾶι	_3	
μιᾶι	a-p---fd-	μιᾶι	_3	
μιᾶι	a-p---fn-	μιᾶι	_3	
μιᾶς	u--------	μιᾶς	_3	
μικρᾶς	a-s---fg-	μικρός	_5	
σμικράς	a-p---fa-	μικρός	_6	
σμικρᾶς	a-s---fg-	μικρός	_6	
σμικρᾶς	a-p---fa-	μικρός	_6	
Μινύας	n-s---mn-	Μινύας		
μοίρας	n-s---fg-	μοῖρα	_5	
μοίρας	n-p---fa-	μοῖρα	_5	
Μοίρας	n-p---fa-	μοῖρα		
Μοίρας	n-s---fg-	μοῖρα		
Μολοσσίας	n-p---fa-	Μολοσσίη		
μολπάν	n-s---ma-	μολπὰς	_5	
μολπὰν	n-s---ma-	μολπὰς	_5	
μολπάς	n-p---fa-	μολπή	_5	
μολπὰς	n-p---fa-	μολπή	_5	
μομφάς	n-p---fa-	μομφή	_5	
μομφὰς	n-p---fa-	μομφή	_5	
μοναρχίας	n-s---fg-	μοναρχία	_8	
μόνα	a-d---fn-	μόνος	_4	
μόνας	a-p---fa-	μόνος	_4	
μόραν	n-s---ma-	μόρης	_4	
μορφάς	n-p---fa-	μορφή	_5	
μορφάς	n-p---fa-	μορφή	_5	
μορφὰς	n-p---fa-	μορφή	_5	
μούσας	n-p---fa-	μοῦσα	_5	
μούσας	n-s---fg-	μοῦσα	_5	
Μούσας	n-p---fa-	μοῦσα		
μοχθήσας	v-sapamn-	μοχθέω	_7	
μυδώσας	v-sapamn-	μυδώω	_6	
μυκᾶται	v3spie---	μυκάομαι	_4	
Μυκήνας	n-p---fa-	μυκήνη		
μυριάδας	n-p---fa-	μυριάς	_7	
μυριάς	a-p---fa-	μυριάς	_5	
μυριὰς	a-p---fa-	μυριὰς	_5	
μυρίας	a-p---fa-	μυρίος	_5	
μυρίας	a-s---fg-	μυρῖος	_5	
μυρσίνας	n-p---fa-	μυρσίνη	_7	
μυσαρᾶς	n-s---fg-	μυσαρή	_6	
μωρίας	n-p---fa-	μωρία	_5	
μωρίας	n-s---fg-	μωρία	_5	
νᾶεςπανωλέθροισιν	a-p---fd-	νᾶεςπανωλέθροισιν	_2	
νάπας	n-p---fa-	νάπα	_4	
ναπαίας	n-p---fa-	ναπαίη	_4	
νάπας	n-p---fa-	νάπη	_4	
ναυαγίας	n-s---fg-	ναυαγία	_4	
ναυβατᾶν	n-p---mn-	ναυβατᾶν	_5	
ναυβάταν	n-s---ma-	ναυβάτας	_5	
ναυβάτας	n-s---mn-	ναυβάτης	_5	
ναυκληρίας	n-s---fg-	ναυκληρία	_2	
Ναυπακτίας	n-s---fg-	Ναυπακτία	_5	
Ναυπλίας	a-p---fa-	Ναυπλία		
Ναυπλίας	a-s---fg-	Ναυπλῖος		
νέας	n-p---fa-	ναῦς	_3	
νέας	a-s---fg-	ναῦς	_3	
ναύταν	n-s---ma-	ναύτης	_2	
νεανία	n-s---mv-	νεανία	_6	
νεανιᾶν	a-s---fa-	νεανιᾶν	_6	
νεανίαν	n-s---ma-	νεανίας	_6	
νεανίας	n-s---mn-	νεανίας	_6	
νεαράς	a-p---fa-	νεαράς	_5	
νεαρὰς	a-p---fa-	νεαρὰς	_5	
νεαρᾶς	a-p---fa-	νεαρᾶς	_5	
νεβρίδας	n-p---fa-	νεβρίδαι	_7	
νεβρίδα	n-s---mv-	νεβρίδας	_7	
νειφομένας	v-pppefa-	νειφομένας	_9	
Νεμέας	n-s---fg-	Νεμέα		
νεότας	n-s---fg-	νεός	_5	
νέας	a-s---fg-	νέος	_3	
νέας	a-p---fa-	νέος	_3	
νεωτέρας	a-s---fgc	νέος	_7	
νερτέρας	a-s---fg-	νερτέρας	_7	
νερτέρας	a-p---fa-	νερτέρη	_7	
νευράς	n-p---fa-	νευράς	_5	
νεφέλας	n-p---fa-	νεφέλη	_6	
νας	v-pppafa-	νη	_2	
ναΐας	a-s---fg-	νήιος	_4	
νησαίας	a-p---fa-	νησαίας	_4	
νικᾶι	v2spie---	νικᾶι	_4	
νικᾶι	v3spsa---	νικᾶι	_4	
νικᾶι	v3spia---	νικᾶι	_4	
νικᾶις	v2spia---	νικᾶις	_4	
νικᾶν	v--pna---	νικᾶν	_4	
νικᾶσθαι	v--pne---	νικάομαι	_4	
νικᾶτε	v2ppma---	νικᾶτέ	_4	
ἐνίκα	v3siia---	νικάω	_5	
νικᾷ	v3spia---	νικάω	_4	
νικᾷ	v3spsa---	νικάω	_4	
Νικᾷ	v3spia---	νικάω		
νίκα	v2spma---	νικάω	_4	
νικᾶν	v--pna---	νικάω	_4	
Νικᾶν	v--pna---	νικάω		
νικᾶτε	v2ppma---	νικάω	_4	
νικάτω	v3spma---	νικάω	_4	
νικήσας	v-sapamn-	νικάω	_6	
Νιόβα	n-s---mv-	Νιόβας		
νοήσας	v-sapamn-	νοέω	_5	
νομάς	n-p---fa-	νομάι	_4	
νομάδας	n-p---fa-	νομάς	_6	
νομίσας	v-sapamn-	νομίζω	_6	
νοσήσας	v-sapamn-	νοσέω	_6	
νοσηλείας	n-s---fg-	νοσηλείας	_8	
νοστήσας	v-sapamn-	νοστέω	_7	
νοσφίσας	v-sapamn-	νοσφίζω	_7	
Νυμφαίας	a-p---fa-	Νυμφαῖος		
νύμφαν	n-s---ma-	νύμφαν	_5	
νυμφεύσας	v-sapamn-	νυμφεύω	_8	
νυμφᾶν	n-s---fa-	νύμφη	_5	
Νυμφᾶν	n-p---fg-	νύμφη		
Νυμφᾶν	n-s---ma-	νύμφη		
Νυμφᾶν	n-p---fn-	νύμφη		
νύμφας	n-s---fg-	νύμφη	_5	
νύμφας	n-p---fa-	νύμφη	_5	
Νύμφας	n-p---fa-	νύμφη		
νυμφικάς	n-p---fa-	νυμφικάς	_7	
νυμφικάς	n-p---fa-	νυμφικάς	_7	
νυμφικὰς	n-p---fa-	νυμφικὰς	_7	
νύκτας	n-p---fa-	νύξ	_5	
Νύσας	v-pppafa-	Νύσας		
ἐνώμα	v3siia---	νωμάω	_5	
ξανθᾶι	a-p---fn-	ξανθᾶι	_5	
ξανθάς	a-p---fa-	ξανθός	_5	
ξανθὰς	a-p---fa-	ξανθός	_5	
ξένας	n-p---fa-	ξέ	_4	
ξεινοδαΐκταν	a-s---ma-	ξεινοδαΐκτης	_11	
ξενίας	n-p---fa-	ξενία	_5	
ξενίας	n-s---fg-	ξενία	_5	
ξένας	a-s---fg-	ξένος	_4	
ξένας	a-p---fa-	ξένος	_4	
ξυμβεβᾶσι	v3pria---	ξυμβεβᾶσί	_7	
Ξύμπας	a-s---mn-	Ξύμπας		
ξυμπερᾶναι	v--ana---	ξυμπεραίνω	_7	
ξυμπολῖται	n-p---fv-	ξυμπολῖτος	_7	
ξυμφοράς	n-p---fa-	ξυμφορά	_7	
ξυμφορὰς	n-p---fa-	ξυμφορά	_7	
ξυμφορᾶς	a-s---fg-	ξυμφορά	_7	
ξυμφορᾶς	n-s---fg-	ξυμφορά	_7	
ξυμφορᾶι	n-p---fn-	ξυμφορᾶ	_7	
ξυμφορᾶς	n-s---fg-	ξυμφορᾶ	_7	
ξυμφορᾷ	n-s---fd-	ξυμφορᾷ	_7	
ξυμφορᾷ	n-p---na-	ξυμφορᾷ	_7	
ξυμφορᾷ	a-p---na-	ξυμφορᾷ	_7	
ξυμφοράς	n-p---fa-	ξυμφοράς	_7	
ξυμφορὰς	n-p---fa-	ξυμφορὰς	_7	
ξυμφορᾶι	n-p---fn-	ξυμφορᾶς	_7	
ξυμφορᾶς	n-p---fa-	ξυμφορᾶς	_7	
ξυμφορᾶς	n-s---fg-	ξυμφορᾶς	_7	
Ξυμφορᾶς	n-s---fg-	Ξυμφορή		
ξυνάψας	v-sapamn-	ξυνάπτω	_6	
ξυναρτήσας	v-sapamn-	ξυναρτέω	_9	
ξυνασχαλᾷ	v3spia---	ξυνασχαλάω	_9	
ξυνεισβάς	v-sapamn-	ξυνεισβαίνω	_8	
ξυνεισβὰς	v-sapamn-	ξυνεισβαίνω	_8	
ξυνουσίᾳ	a-p---na-	ξυνουσίᾳ	_8	
ξυνουσίας	n-s---fg-	ξυνουσίας	_8	
ξυνουσίᾳ	a-s---fd-	ξυνουσῖος	_8	
ξυνωρίδας	n-p---fa-	ξυνωρίς	_8	
ξυστᾶσ’	v-sapafn-	ξυστᾶσ	_5	
Ὄγκας	n-p---fa-	Ὄγκη		
ὀδοντοφυᾶ	a-s---fa-	ὀδοντοφυᾶ	_9	
ὀδυνᾶι	v2spie---	ὀδυνᾶι	_5	
ὀδυνᾶν	v1saia---	ὀδυνάω	_5	
ὀδύνας	n-s---fg-	ὀδύνη	_5	
ὀδύνας	n-p---fa-	ὀδύνη	_5	
ἴσασι	v3pria---	οἶδα	_3	
ἴσασιν	v3pria---	οἶδα	_3	
Οἰδιπόδα	n-s---mg-	Οἰδιπόδα		
Οἰδιπόδα	n-s---mg-	οἰδιπόδης		
Οἰδιπόδαν	n-s---ma-	Οἰδιπόδης		
Οἰδιπόδα	n-s---mv-	οἰδίπους		
οἰκείας	a-s---fg-	οἰκεῖος	_6	
οἰκείας	a-p---fa-	οἰκεῖος	_6	
οἰκουμένας	v-pppefa-	οἰκεύω	_9	
οἰκήσας	v-sapamn-	οἰκέω	_6	
οἰκίας	n-p---fa-	οἰκία	_5	
οἰκουρίας	a-s---fg-	οἰκουρία	_8	
οἰκτίρας	v-sapamn-	οἰκτείρω	_7	
οἰκτίσας	v-sapamn-	οἰκτίζω	_7	
οἰκτράς	a-p---fa-	οἰκτρός	_6	
οἰμωγάς	n-p---fa-	οἰμωγή	_6	
οἰμωγὰς	n-p---fa-	οἰμωγή	_6	
οἰμώξας	v-sapamn-	οἰμώζω	_6	
οἰνάνθας	n-p---fa-	οἰνάνθη	_7	
οἴνας	n-s---fg-	οἴνη	_4	
οἰνηράς	a-p---fa-	οἰνηρός	_6	
οἰνηρὰς	a-p---fa-	οἰνηρός	_6	
Οἰνιαδᾶν	n-p---mg-	οἰνιάδαι	_7	
οἰνοδόταν	n-s---ma-	οἰνοδότα	_8	
Οἰνωᾶτιν	n-s---ma-	Οἰνωᾶτις		
οἰοβώτας	n-s---mn-	οἰοβώτας	_7	
οἵας	n-p---fa-	οἷος	_3	
οἵας	a-s---fg-	οἷος	_3	
οἵας	a-p---fa-	οἷος	_3	
οἴξας	v-sapamn-	οἴσσω	_4	
οἰστρήσας	v-sapamn-	οἰστράω	_8	
Οἴτας	n-p---fa-	Οἴτη		
Οἰχαλίας	n-s---fg-	Οἰχαλία	_7	
οἰχομένας	v-sppefg-	οἰχομένας	_8	
οἰχομένας	v-pppefa-	οἰχομένας	_8	
οἰωνοθέτας	n-s---mn-	οἰωνοθέτης	_9	
ὀκλάσας	v-sapamn-	ὀκλάω	_6	
ὀλβίσας	v-sapamn-	ὀλβίζω	_6	
ὀλβίας	a-s---fg-	ὀλβῖος	_5	
ὀλβοδόταν	n-s---ma-	ὀλβοδότης	_8	
ὀλέσας	v-sapamn-	ὄλλυμι	_5	
ὀλέσσας	v-sapamn-	ὄλλυμι	_6	
ὄλλυσιν	v3spia---	ὄλλυμι	_4	
ὀλλυμένας	v-sppefg-	ὀλόλμαι	_8	
ὀλομένας	a-s---fg-	ὀλομένας	_7	
ὀλομένας	v-pppafa-	ὀλομένας	_7	
ὀλομένας	v-sppefg-	ὀλομένας	_7	
ὀλοάς	a-p---fa-	ὀλοός	_4	
ὀλοὰς	a-p---fa-	ὀλοός	_4	
ὁμαυλίας	n-s---fg-	ὁμαυλία	_3	
ὁμηρεύσας	v-sapamn-	ὁμηρεύω	_8	
ὁμιλίας	n-s---fg-	ὁμιλία	_6	
ὁμιλίας	n-p---fa-	ὁμιλία	_6	
ὄμνυμι	v1spia---	ὄμνυμι	_4	
ὀμόσας	v-sapamn-	ὄμνυμι	_5	
ὁμοίας	a-p---fa-	ὅμοιος	_5	
ὁμοίας	a-s---fg-	ὅμοιος	_5	
Ὁμόλας	n-p---fa-	Ὁμόλη		
ὀμφάς	n-p---fa-	ὀμφή	_4	
ὀμφὰς	n-p---fa-	ὀμφή	_4	
ὀνομάσας	v-sapamn-	ὀνομάζω	_7	
ὀξυβόαν	a-s---ma-	ὀξυβόας	_6	
ὀξυθυμίας	n-s---fg-	ὀξυθυμία	_8	
ὁπλίσας	v-sapamn-	ὁπλίζω	_6	
ὁποίας	a-s---fg-	ὁποῖος	_5	
ὁπόσας	a-p---fa-	ὁπόσας	_5	
ὀπτάς	a-p---fa-	ὀπτή	_4	
ὀπώρας	n-s---fg-	ὀπώρα	_5	
ὅρα	v2spma---	ὅρα	_3	
Ὅρα	v2spma---	Ὅρα		
ὁρωμένας	v-pppefa-	ὁράομαι	_7	
ὅρα	v2spma---	ὁράω	_3	
Ὅρα	v2spma---	ὁράω		
ὥρα	v3siia---	ὁράω	_3	
Ὥρα	v3siia---	ὁράω		
ὀργάδας	n-p---fa-	ὀργάς	_6	
ὀργάς	n-p---fa-	ὀργάς	_4	
ὀργάς	n-p---fa-	ὀργή	_4	
ὀργάς	n-p---fa-	ὀργή	_4	
ὀργὰς	n-p---fa-	ὀργή	_4	
ὀρέξας	v-sapamn-	ὀρέγω	_5	
ὀρεσσιβάτα	n-s---mg-	ὀρεσσιβάτης	_10	
Ὀρέστα	n-s---mv-	Ὀρέστας		
Ὀρέσταν	n-s---ma-	Ὀρέστας		
Ὀρεστείας	a-s---fg-	Ὀρεστείας		
Ὀρέστα	n-s---mv-	ὀρέστης		
ὀρθομαντείας	n-s---fg-	ὀρθομαντείη	_11	
ὀρθάς	a-p---fa-	ὀρθός	_4	
ὀρθὰς	a-p---fa-	ὀρθός	_4	
ὁρκανάς	n-p---fa-	ὁρκαναί	_6	
ὁρκανὰς	n-p---fa-	ὁρκαναί	_6	
ὁρκωμοτήσας	v-sapamn-	ὁρκωμοτέω	_10	
ὁρμάσας	v-sapamn-	ὁρμάζω	_6	
ὁρμωμένας	v-pppefa-	ὁρμάομαι	_8	
ὁρμήσας	v-sapamn-	ὁρμέω	_6	
ὀρνυμένας	v-pppefa-	ὀρόνμαι	_8	
ὀρούσας	v-sapamn-	ὀρούω	_6	
ὁρώσας	v-sapamn-	ὁρόω	_5	
ὀρείας	a-s---fg-	ὀρύς	_5	
ὀρύξας	v-sapamn-	ὀρύσσω	_5	
ὀρφανάς	a-p---fa-	ὀρφανός	_6	
ὀρφανὰς	a-p---fa-	ὀρφανός	_6	
ὀρφναίας	a-p---fa-	ὀρφναίας	_5	
ὀρφναίας	a-s---fg-	ὀρφναῖος	_5	
ὁρώσας	v-pppafa-	ὁρώσας	_5	
ὁσίας	n-p---fa-	ὁσία	_4	
ὁσίας	a-p---fa-	ὁσῖος	_4	
ὁσίας	a-s---fg-	ὁσῖος	_4	
ὅσας	a-p---fa-	ὅσος	_3	
Ὄσσας	n-p---fa-	Ὄσση		
ὅσσας	a-p---fa-	ὅσση	_4	
οὐδαμᾷ	a-p---nn-	οὐδαμᾷ	_6	
οὐδαμᾷ	a-p---na-	οὐδαμᾷ	_6	
οὐρανίας	a-s---fg-	οὐρανῖος	_7	
οὐρείας	a-p---fa-	οὐρεῖος	_6	
οὐρεσιβώτας	n-s---mn-	οὐρεσιβώτας	_10	
οὐρίσας	v-sapamn-	οὐρίζω	_6	
οὐριθρέπταν	a-s---ma-	οὐριθρέπτης	_10	
οὐρίας	a-s---fg-	οὐρῖος	_5	
οὐσίας	n-s---fg-	οὐσία	_5	
οὐτάσας	v-sapamn-	οὐτάω	_6	
ταύτας	a-p---fa-	οὗτος	_2	
Ταύτας	a-p---fa-	οὗτος		
ὄχθας	n-p---fa-	ὄχθας	_4	
ὄχθας	n-p---fa-	ὄχθη	_4	
χυμένας	v-pppefa-	όχμαι	_6	
παγκοίτας	n-s---fg-	παγ	_8	
παγάς	n-p---fa-	παγὰι	_4	
παγὰς	n-p---fa-	παγὰι	_4	
παγάς	n-p---fa-	παγάς	_4	
παγάς	n-p---fa-	παγή	_4	
παγκληρίας	n-s---fg-	παγκληρία	_9	
παγκληρίας	a-s---fg-	παγκληρῖος	_9	
πάθας	n-p---fa-	πάθας	_4	
παιάν	n-s---ma-	παιάν	_2	
παιὰν	n-s---ma-	παιάν	_2	
παιδείας	n-s---fg-	παιδεία	_2	
παιδοκτονήσας	v-sapamn-	παιδοκτονέω	_2	
παίσας	v-sapamn-	παίσας	_2	
παίσας	v-sapamn-	παίω	_2	
παιωνίᾳ	a-p---na-	παιωνίᾳ	_2	
παιωνίας	a-p---fa-	παιωνῖος	_2	
παλαιᾶι	a-p---fn-	παλαιᾶι	_4	
παλαιᾶν	a-s---fa-	παλαιᾶν	_4	
παλαιᾷ	a-s---fd-	παλαιός	_4	
παλαιάς	a-p---fa-	παλαιός	_4	
παλαιάς	a-s---fg-	παλαιός	_4	
παλαιὰς	a-p---fa-	παλαιός	_4	
παλαιὰς	a-s---fg-	παλαιός	_4	
παλαιᾶς	a-s---fg-	παλαιός	_4	
παλαιᾶς	a-p---fa-	παλαιός	_4	
παλαίστρας	n-p---fa-	παλαίστρα	_4	
παλάμᾳ	n-p---na-	παλάμη	_6	
πάλας	n-p---fa-	πάλη	_4	
Παλλάς	n-s---fg-	παλλάς	_5	
Παλλὰς	n-s---fg-	παλλάς	_5	
παλύνας	v-sapamn-	παλύνω	_6	
πανδημίᾳ	a-s---fn-	πανδημίᾳ	_8	
πανεργέτα	a-s---mv-	πανεργέτα	_9	
Πανθοΐδαν	n-s---ma-	Πανθοίδας	_8	
πανουργίᾳ	n-s---fd-	πανουργία	_9	
πανουργίας	n-s---fg-	πανουργία	_9	
πανσαγίᾳ	n-p---na-	πανσαγίᾳ	_8	
παντᾶ	a-s---ma-	παντᾶ	_5	
πάντᾳ	a-p---na-	πάντᾳ	_5	
παντευχίᾳ	a-p---na-	παντευχίᾳ	_9	
παντᾷ	a-p---nn-	πάντῃ	_5	
παντοδαπᾶς	a-p---fa-	παντοδαπᾶς	_9	
παντοίᾳ	a-s---fd-	παντοῖος	_7	
παντοίας	a-p---fa-	παντοῖος	_7	
παντοίας	a-s---fg-	παντοῖος	_7	
παντόπτας	n-s---mn-	παντόπτης	_8	
παπτήνας	v-sapamn-	παπταίνω	_7	
παραβᾶσιν	n-s---fa-	παραβᾶσι	_6	
παραγγείλας	v-sapamn-	παραγγέλλω	_10	
παραδοχάς	n-p---fa-	παραδοχάς	_8	
παραιτουμένᾳ	v-dppefn-	παραιτουμένᾳ	_4	
παραλίας	n-s---fg-	παραλῖα	_7	
παραλλαγάς	n-p---fa-	παραλλαγή	_9	
παραμυκᾶται	v3spie---	παραμυκάομαι	_8	
παρανικᾷ	v3spia---	παρανικᾷ	_8	
παρασπᾷ	v3spia---	παρασπάω	_7	
παρασπᾷς	v2spia---	παρασπάω	_7	
παραστάδας	n-p---fa-	παραστάς	_9	
παραστᾶσ’	v-sapafn-	παραστᾶσ’	_7	
παρβάδαν	n-s---ma-	παρβάδης	_7	
παρειᾷ	n-s---fd-	παρειά	_6	
παρελθούσας	v-sapafg-	παρελθούσας	_10	
παρεστώσας	v-sapafg-	παρεστώσας	_9	
παρηίδας	n-p---fa-	παρηίδας	_7	
παρηίδας	n-p---fa-	παρηίς	_7	
παρθενείας	n-p---fa-	παρθενεία	_9	
παρθενίας	n-s---fg-	παρθενία	_8	
παραστάς	v-sapamn-	παρίστημι	_7	
παραστάς	v-sapamn-	παρίστημι	_7	
παραστὰς	v-sapamn-	παρίστημι	_7	
Παρνασίας	n-s---fg-	Παρνασία	_8	
Παρνασίας	n-s---mn-	Παρνασίη	_8	
παροίξας	v-sapamn-	παροίξας	_7	
παρούσας	v-pppafa-	παρούσας	_7	
παρώσας	v-sapamn-	παρωθέω	_6	
πασᾶν	a-p---fg-	πᾶς	_4	
πασᾶν	a-s---fa-	πᾶς	_4	
πάσας	a-s---fg-	πᾶς	_4	
πάσας	a-p---fa-	πᾶς	_4	
πάσᾳ	a-s---fn-	πάσᾳ	_4	
πασαμένα	v-dapmfn-	πασαμένα	_8	
πασᾶνγυναικων	a-p---fg-	πασᾶνγυναικῶν	_4	
πάσας	a-p---fa-	πάσας	_4	
πατάξας	v-sapamn-	πατάσσω	_6	
πάτας	n-p---fa-	πάτη	_4	
πατουμένας	v-sppefg-	πατόομαι	_9	
πάτρας	n-s---fg-	πάτρα	_5	
πάτρᾳ	n-s---fn-	πάτρᾳ	_5	
πατρίας	a-s---fg-	πατρίη	_6	
πατρίας	a-p---fa-	πατρίη	_6	
πατρίας	a-s---fg-	πατρῖος	_6	
πατριώταν	n-s---ma-	πατριώτης	_8	
πατρῴᾳ	a-s---fd-	πατρῴᾳ	_6	
πατρῴας	a-s---fg-	πατρῷος	_6	
πάχνᾳ	a-p---na-	πάχνᾳ	_5	
παχῦναι	v--ana---	παχύνω	_4	
πέδας	n-p---fa-	πέδας	_4	
πεδήσας	v-sapamn-	πεδάω	_6	
πέδας	n-p---fa-	πέδη	_4	
πείσας	v-sapamn-	πείθω	_5	
Πειρήνας	n-p---fa-	Πειρήνη		
πείσας	v-sapamn-	πείσας	_5	
πελαγίας	a-s---fg-	πελαγῖος	_7	
Πελασγίας	n-s---fg-	Πελασγία	_8	
πελάταν	n-s---ma-	πελάτης	_6	
πελάσας	v-sapamn-	πελάω	_6	
πελειάς	n-s---fg-	πελειά	_6	
πελειάς	n-s---fg-	πελειά	_6	
πελειὰς	n-s---fg-	πελειά	_6	
πελείας	n-p---fa-	πελείας	_6	
πελείας	n-p---fa-	πελείη	_6	
πελείας	n-s---fg-	πελείη	_6	
Πελιάδας	n-p---fa-	Πελιάδας	_7	
Πελιάδας	n-p---fa-	Πελιάδες	_7	
Πελοπίας	n-s---fg-	Πελοπῖα		
Πελοπίας	n-s---fg-	Πελοπῖος		
πέλτας	n-p---fa-	πέλτη	_5	
πέμψας	v-sapamn-	πέμπω	_5	
πέρα	v2spma---	πέρα	_4	
περάνας	v-sapamn-	περαίνω	_6	
πέρας	n-s---na-	πέρας	_4	
περάσας	v-sapamn-	περάσας	_6	
περάσας	v-sapamn-	περάω	_6	
πέρσας	v-sapamn-	πέρθω	_5	
περιβολάς	n-p---fa-	περιβολή	_8	
περιβολὰς	n-p---fa-	περιβολή	_8	
περιδρομάς	n-p---fa-	περιδρομή	_9	
περιδρομὰς	n-p---fa-	περιδρομή	_9	
περιπλοκάς	n-p---fa-	περιπλοκά	_9	
περιπλοκὰς	n-p---fa-	περιπλοκά	_9	
περιποτᾶται	v3spie---	περιποτάομαι	_8	
περιπτύξας	v-sapamn-	περιπτύσσω	_9	
περιρρύτας	a-p---fa-	περιρρύτας	_9	
περιστᾶσαι	v-papafn-	περιστάζω	_7	
περιστείλας	v-sapamn-	περιστέλλω	_10	
Πέρσαν	n-s---ma-	Πέρσας		
Περσεφονείας	n-s---fg-	Περσεφονεία		
Περσεφόνας	n-p---fa-	Περσεφόνη		
πέρσαν	n-s---ma-	πέρσης	_5	
πεσούσας	v-papafa-	πεσίσκομαι	_7	
πέτρας	n-s---fg-	πέτρα	_5	
πέτρας	n-p---fa-	πέτρα	_5	
πετραίας	a-s---fg-	πετραῖος	_5	
πέτρας	n-p---fa-	πέτρας	_5	
πετρίνας	a-p---fa-	πετρίνας	_7	
πετομένας	v-pppefa-	πέτω	_8	
πεύκας	n-p---fa-	πεύκαι	_5	
πεύκας	n-p---fa-	πεύκας	_5	
πεφαργμένας	v-prpefa-	πεφαργμένας	_10	
πεφεύγασιν	v3pria---	πεφεύγασιν	_7	
πεφυρμένας	v-prpefa-	πεφυρμένας	_9	
πηγάς	n-p---fa-	Πηγαί	_4	
πηγάς	n-p---fa-	πηγή	_4	
πηγὰς	n-p---fa-	πηγή	_4	
πήγνυσιν	v3ppia---	πήγνυς	_5	
πηδήσας	v-sapamn-	πηδάω	_6	
πηδήσας	v-sapamn-	πηδέω	_6	
Πηλεΐδας	n-s---mn-	Πηλεΐδαι		
πημήνας	v-sapamn-	πημήνας	_6	
πημονάς	n-p---fa-	πημονή	_6	
πημονὰς	n-p---fa-	πημονή	_6	
Πιερίδας	n-p---fa-	Πιερίς		
πικράς	a-s---fg-	πικράς	_5	
πικρὰς	a-s---fg-	πικρὰς	_5	
πικρᾷ	a-s---fd-	πικρός	_5	
πικράς	a-s---fg-	πικρός	_5	
πικράς	a-p---fa-	πικρός	_5	
πικρὰς	a-s---fg-	πικρός	_5	
πικρὰς	a-p---fa-	πικρός	_5	
πικρᾶς	a-s---fg-	πικρός	_5	
πικρᾶς	a-p---fa-	πικρός	_5	
πλήσας	v-sapamn-	πίμπλημι	_5	
πιμπρᾶσιν	v3ppia---	πιμπρᾶ	_6	
πιμπρᾶσι	v3spia---	πιμπρᾶμί	_6	
πιστεύσας	v-sapamn-	πιστεύω	_8	
πιστάς	a-p---fa-	πιστός	_5	
πιστὰς	a-p---fa-	πιστός	_5	
πιστοτάτας	a-p---fas	πιστός	_9	
Πιτάνας	n-s---fg-	Πιτάνη	_6	
πιτνούσας	v-pppafa-	πιτνούσας	_8	
πιείρας	a-s---fg-	πίων	_6	
πλαγᾶι	n-p---fn-	πλαγᾶι	_5	
πλαγάς	n-p---fa-	πλαγή	_5	
πλαγὰς	n-p---fa-	πλαγή	_5	
πλάκας	n-p---fa-	πλάκας	_5	
πλάκας	n-p---fa-	πλάκη	_5	
πλανᾷ	v3spia---	πλανάω	_5	
πλανᾶσθαι	v--pne---	πλανάω	_5	
πλανᾶσθε	v2ppie---	πλανάω	_5	
πλάνας	n-p---fa-	πλάνη	_5	
πλατᾶν	n-s---fa-	πλατᾶν	_5	
πλατείας	n-s---fg-	πλατεῖα	_7	
πλάτας	n-p---fa-	πλάτη	_5	
Πλειάδας	n-s---fg-	Πλειάδας	_7	
Πλειάς	n-p---fa-	Πλειάς		
Πλειὰς	n-p---fa-	Πλειὰς		
Πλεισθενιδᾶν	n-s---ma-	Πλεισθενίδης		
πλείστας	a-p---fa-	πλεῖστος	_7	
πλεκτάς	a-p---fa-	πλεκτός	_6	
πλεκτὰς	a-p---fa-	πλεκτός	_6	
πλευράς	n-p---fa-	πλευρά	_6	
πλευράς	n-p---fa-	πλευρά	_6	
πλευρὰς	n-p---fa-	πλευρά	_6	
πλεύσας	v-sapamn-	πλέω	_6	
πληγάς	n-p---fa-	πληγή	_5	
πληγάς	n-p---fa-	πληγή	_5	
πληγὰς	n-p---fa-	πληγή	_5	
πλημμελήσας	v-sapamn-	πλημμελέω	_10	
πλησίας	a-s---fg-	πλησίας	_6	
πλησμονάς	n-p---fa-	πλησμονά	_8	
πλησμονὰς	n-p---fa-	πλησμονά	_8	
πλοκάς	n-p---fa-	πλοκή	_5	
πλοκὰς	n-p---fa-	πλοκή	_5	
πνεύσας	v-sapamn-	πνέω	_6	
πνοάς	n-p---fa-	πνοάς	_4	
πνοάς	n-p---fa-	πνοή	_4	
πνοάς	n-p---fa-	πνοή	_4	
πνοὰς	n-p---fa-	πνοή	_4	
ποδωκείας	n-s---fg-	ποδωκεεία	_8	
ποίας	a-s---fg-	ποίας	_4	
ποιήσας	v-sapamn-	ποιέω	_6	
ποικίλας	v-sapamn-	ποικίλλω	_7	
ποίμνας	n-p---fa-	ποίμνη	_6	
ποινάς	n-p---fa-	ποινή	_5	
ποινάς	n-p---fa-	ποινή	_5	
ποινὰς	n-p---fa-	ποινή	_5	
ποίας	a-s---fg-	ποῖος	_4	
ποίας	a-p---fa-	ποῖος	_4	
Ποίας	a-s---fg-	ποῖος		
Ποίας	a-p---fa-	ποῖος		
πολεμίας	a-s---fg-	πολεμῖος	_7	
πολεμίας	a-p---fa-	πολεμῖος	_7	
πολεμίᾳ	a-s---fd-	πολέμιος	_7	
πολιαινομένας	v-pppefa-	πολιαινομένας	_5	
πολιᾶν	a-s---fa-	πολιᾶν	_5	
Πολιάς	n-p---fa-	Πολιάς		
πολιᾶς	n-p---fa-	πολιᾶς	_5	
πολιάς	n-p---fa-	πολιός	_5	
πολιάς	a-p---fa-	πολιός	_5	
πολιὰς	n-p---fa-	πολιός	_5	
πολιὰς	a-p---fa-	πολιός	_5	
πολιτᾶν	n-s---fa-	πολιτᾶν	_6	
πολιτᾶν	n-s---ma-	πολιτᾶν	_6	
πολιτᾶν	a-s---fa-	πολιτάω	_6	
πλείστας	a-p---fas	πολύς	_7	
πολλά	a-d---fn-	πολύς	_5	
πολλὰ	a-d---fn-	πολύς	_5	
πολλάς	a-p---fa-	πολύς	_5	
πολλάς	a-p---fa-	πολύς	_5	
Πολλάς	a-p---fa-	πολύς		
πολλὰς	a-p---fa-	πολύς	_5	
Πολλὰς	a-p---fa-	πολύς		
πολύτλας	a-s---mn-	πολύτλας	_7	
πονήσας	v-sapamn-	πονέω	_6	
πονηράς	a-p---fa-	πονηρός	_6	
πονηρὰς	a-p---fa-	πονηρός	_6	
ποντίας	n-s---fg-	ποντία	_6	
ποντιᾶν	a-s---fa-	ποντιᾶν	_6	
ποντιάς	a-s---fg-	ποντιάς	_6	
ποντιὰς	a-s---fg-	ποντιὰς	_6	
ποντίας	a-s---fg-	ποντίη	_6	
ποντίας	n-s---fg-	ποντίη	_6	
ποντίας	a-s---fg-	ποντῖος	_6	
ποντίας	a-p---fa-	ποντῖος	_6	
πορείας	n-s---fg-	πορεία	_6	
πορεύσας	v-sapamn-	πορεύω	_7	
πορθουμένας	v-pppafa-	πορθόομαι	_10	
πόρπας	n-p---fa-	πόρπη	_5	
πορσύνας	v-sapamn-	πορσύνω	_7	
πορφυρᾷ	n-s---fd-	πορφυρᾷ	_7	
πορφύρας	n-s---fg-	πορφύρα	_7	
πορφυρέας	a-p---fa-	πορφύρεος	_8	
πόσας	a-p---fa-	πόσος	_4	
ποταμίας	a-p---fa-	ποταμῖος	_7	
ποταμίας	a-s---fg-	ποταμῖος	_7	
ποτνιάδας	n-p---fa-	ποτνιάς	_8	
πράξας	v-sapamn-	πράξας	_5	
πράξας	v-sapamn-	πράσσω	_5	
Πριαμίδαν	n-s---ma-	Πριαμίδαν	_8	
πρόβα	v2spma---	πρόβα	_5	
προβάς	v-sapamn-	προβαίνω	_5	
προβάς	v-sapamn-	προβαίνω	_5	
προβὰς	v-sapamn-	προβαίνω	_5	
πρόβα	v2spma---	πρόβη	_5	
προδείσας	v-sapamn-	προδείδω	_8	
προδεικνύς	v-sppamn-	προδείκνυμι	_9	
προδεικνὺς	v-sppamn-	προδείκνυμι	_9	
προδόταν	n-s---ma-	προδότης	_7	
προθυμίας	n-p---fa-	προθυμία	_8	
προθυμίας	n-s---fg-	προθυμία	_8	
Προιτίδας	a-p---fa-	Προιτίδας		
προκλίνας	v-sapamn-	προκλίνω	_8	
προκρίνας	v-sapamn-	προκρίνω	_8	
προμεμοχθήκασι	v3pria---	προμεμοχθίσκω	_12	
προμηθίᾳ	n-s---fn-	προμήθειᾳ	_8	
προμηθίᾳ	n-s---fd-	προμηθία	_8	
προμηθίας	n-s---fg-	προμηθία	_8	
προνοίας	n-s---fg-	πρόνοια	_7	
πρόπας	a-s---mn-	πρόπας	_5	
προπονουμένας	v-sppefg-	προπονέω	_12	
προσάψας	v-sapamn-	προσάπτω	_7	
προσαρμόσας	v-sapamn-	προσαρμόζω	_10	
προσβάς	v-sapamn-	προσβαίνω	_6	
προσβὰς	v-sapamn-	προσβαίνω	_6	
προσβλέψας	v-sapamn-	προσβλέπω	_9	
προσβολάς	n-p---fa-	προσβολή	_8	
προσβολάς	n-p---fa-	προσβολή	_8	
προσβολὰς	n-p---fa-	προσβολή	_8	
προσδόκα	v2spma---	προσδοκάω	_8	
προσέβα	v3siia---	προσέβα	_7	
προσέπτα	v3siia---	προσέπτα	_8	
προσερπούσας	v-pppafa-	προσερπούσας	_11	
προσηγορήσας	v-sapamn-	προσηγορέω	_11	
προσενώμα	v3siia---	προσινωμάω	_9	
προσκύσας	v-sapamn-	προσκύω	_8	
προσπέμψας	v-sapamn-	προσπέμπω	_9	
προσπολουμένας	v-pppefa-	προσπολόομαι	_13	
προστάξας	v-sapamn-	προστάσσω	_8	
προστάταν	n-s---ma-	προστάταν	_8	
προστατηρίας	n-s---fg-	προστατηρία	_11	
προστάταν	n-s---ma-	προστάτης	_8	
προτάξας	v-sapamn-	προτάσσω	_7	
προτείνας	v-sapamn-	προτείνον	_8	
προτέρας	a-p---fa-	πρότερος	_7	
πρώτας	a-p---fas	πρότερος	_5	
προτίσας	v-sapamn-	προτίζω	_7	
προτιμᾶι	v3spia---	προτιμᾶι	_7	
προτιμᾷ	v3spia---	προτιμάω	_7	
προυμόσας	n-p---fa-	προυμόση	_8	
προχοάς	n-p---fa-	προχοή	_6	
προχοὰς	n-p---fa-	προχοή	_6	
πρυμνᾶν	n-s---fa-	πρυμνᾶ	_6	
πρύμνας	n-s---fg-	πρύμνα	_6	
πρύμνας	n-p---fa-	πρύμνα	_6	
πρῴρας	n-p---fa-	πρῷρα	_5	
πρώτας	a-p---fa-	πρῶτος	_5	
πταίσας	v-sapamn-	πταίω	_3	
πτερωτάς	a-p---fa-	πτερωτός	_7	
πτερωτὰς	a-p---fa-	πτερωτός	_7	
πτήξας	v-sapamn-	πτήζω	_5	
πτύξας	v-sapamn-	πτύσσω	_5	
πτυχάς	n-p---fa-	πτυχάς	_5	
πτυχάς	n-p---fa-	πτυχάς	_5	
πτυχὰς	n-p---fa-	πτυχὰς	_5	
πτυχάς	n-p---fa-	πτυχή	_5	
πτυχὰς	n-p---fa-	πτυχή	_5	
πτύσας	v-sapamn-	πτύω	_5	
πτωχάς	a-p---fa-	πτωχός	_5	
πτωχὰς	a-p---fa-	πτωχός	_5	
πυκνάς	a-p---fa-	πυκνός	_5	
πυκνὰς	a-p---fa-	πυκνός	_5	
πυλᾶν	n-s---fa-	πυλᾶ	_4	
Πυλάδας	n-s---fg-	Πυλάδη	_6	
πύλας	n-p---fa-	πύλας	_4	
πύλας	n-p---fa-	πύλη	_4	
Πύλας	n-p---fa-	πύλη		
πυρᾶι	n-p---fn-	πυρᾶ	_4	
πυρᾶι	n-p---fd-	πυρᾶ	_4	
πυρᾶι	n-s---fd-	πυρᾶι	_4	
πυρᾶι	u--------	πυρᾶι	_4	
πυργώσας	v-sapamn-	πυργώω	_7	
πυρᾷ	n-s---fd-	πυρή	_4	
πυρᾶς	n-p---fa-	πυρή	_4	
πυρᾶς	n-s---fg-	πυρή	_4	
πυριγενετᾶν	a-p---na-	πυριγενετᾶς	_10	
πυρκαιάς	n-p---fa-	πυρκαιή	_5	
πυρκαιὰς	n-p---fa-	πυρκαιή	_5	
πυρώσας	v-sapamn-	πυρόω	_6	
πυρρίχας	n-p---fa-	πυρρίχη	_7	
πυρσεύσας	v-sapamn-	πυρσεύω	_8	
πωλοδαμνήσας	v-sapamn-	πωλοδαμνάω	_11	
ῥᾴδιον	a-s---nn-	ῥᾴδιος	_2	
ῥᾳδίως	d--------	ῥᾴδιος	_2	
ῥᾴθυμος	a-s---fn-	ῥᾴθυμος	_2	
ῥαφάς	n-p---fa-	ῥαφή	_4	
ῥέξας	v-sapamn-	ῥέδω	_4	
Ῥέας	v-sapamn-	Ῥέη		
Ῥέας	n-s---fg-	Ῥέη		
ῥήξας	v-sapamn-	ῥήγνυμι	_4	
ῥήγνυσιν	v3ppia---	ῥήγνυσιν	_5	
ῥίζας	n-p---fa-	ῥίζα	_4	
ῥίζας	n-s---fg-	ῥίζα	_4	
ῥιπᾶι	n-p---fn-	ῥιπᾶι	_4	
Ῥιπᾶν	n-s---fa-	Ῥιπᾶν		
ῥιπάς	n-p---fa-	ῥιπή	_4	
ῥίψας	v-sapamn-	ῥίπτω	_4	
ῥοάς	n-p---fa-	ῥοή	_3	
ῥοάς	n-p---fa-	ῥοή	_3	
ῥοὰς	n-p---fa-	ῥοή	_3	
ῥυσά	v2spma---	ῥυ	_4	
ῥυσὰ	v2spma---	ῥυ	_4	
ῥυτᾶς	n-p---fa-	ῥυτᾶς	_4	
Σαλαμῖν’	a-s---fa-	Σαλαμῖν		
σαλαμῖνα	n-s---fa-	Σαλαμῖνά	_6	
Σαλαμῖνα	n-s---fa-	σαλαμίς		
Σαλαμῖνος	n-s---fg-	σαλαμίς		
σάρκας	n-p---fa-	σάρξ	_5	
σάς	a-p---fa-	σάς	_2	
σαφηνείᾳ	n-s---fd-	σαφηνείᾳ	_8	
σαφηνίσας	v-sapamn-	σαφηνίζω	_8	
σέβας	n-s---na-	σέβας	_4	
σέβας	n-s---nn-	σέβας	_4	
σέβας	n-s---nv-	σέβας	_4	
σελάνας	n-p---fa-	σελάνη	_6	
σέλας	n-s---nv-	σέλας	_4	
σέλας	n-s---na-	σέλας	_4	
σέλας	n-s---nn-	σέλας	_4	
σελήνας	n-p---fa-	σελήνη	_6	
Σεμέλας	n-s---fg-	Σεμέλα		
Σεμέλας	n-s---mn-	Σεμέλας		
Σεμέλας	n-s---fg-	Σεμέλη		
Σεμέλας	n-p---fa-	Σεμέλη		
σεμνάς	a-p---fa-	σεμνός	_5	
σεμνάς	a-p---fa-	σεμνός	_5	
σεμνὰς	a-p---fa-	σεμνός	_5	
σημήνας	v-sapamn-	σημαίνω	_6	
σιγᾶθ’	v2ppma---	σιγᾶθ	_4	
σιγᾶι	v3spia---	σιγᾶι	_4	
σιγᾶι	v2spie---	σιγᾶι	_4	
σιγᾶι	v--ana---	σιγᾶι	_4	
σιγᾶις	v2spoa---	σιγᾶις	_4	
σιγᾶν	v--pna---	σιγᾶν	_4	
σιγᾶς	n-p---fa-	σιγᾶς	_4	
σιγᾷς	v2spia---	σιγᾷς	_4	
Σιγᾶτ’	v2ppma---	Σιγᾶτ		
σιγᾶτ’	v2ppma---	σιγᾶτ’	_4	
σίγα	v2spma---	σιγάω	_4	
Σίγα	v2spma---	σιγάω		
σιγᾶν	v--pna---	σιγάω	_4	
Σιγᾶν	v--pna---	σιγάω		
σιγᾶτε	v2ppma---	σιγάω	_4	
Σιγᾶτε	v2ppma---	Σιγάω		
σιδηρᾶ	a-p---na-	σιδηρᾶ	_6	
Σιδονίᾳ	a-p---na-	σιδόνιος		
Σιδωνιάς	a-p---fa-	Σιδωνιὰ		
Σιδωνιὰς	a-p---fa-	Σιδωνιὰ		
Σικελίας	n-s---fg-	σικελία		
Σιμοεντιάδας	n-p---fa-	Σιμοεντιάς	_11	
Σιμουντίδας	a-p---fa-	Σιμουντίς		
Σισυφιδᾶν	n-p---mg-	Σισυφίδης		
σιωπᾶσθαι	v--pne---	σιωπάομαι	_5	
σιώπα	v2spma---	σιωπάω	_5	
σιωπᾶν	v--pna---	σιωπάω	_5	
σιωπᾷς	v2spia---	σιωπάω	_5	
σιωπήσας	v-sapamn-	σιωπάω	_7	
σκηνάς	n-p---fa-	σκηνή	_5	
σκηνάς	n-p---fa-	σκηνή	_5	
σκηνὰς	n-p---fa-	σκηνή	_5	
σκηπτουχίᾳ	a-p---na-	σκηπτουχία	_10	
σκήψας	v-sapamn-	σκήπτω	_5	
σκιᾷ	n-s---fn-	σκιά	_4	
σκιᾷ	n-s---fd-	σκιά	_4	
σκιᾶς	n-s---fg-	σκιά	_4	
σκιερᾶι	a-p---fn-	σκιερᾶι	_6	
σκιρτᾷ	a-p---nn-	σκιρτᾷ	_6	
σκοπιάς	n-p---fa-	σκοπιὰ	_6	
σκοπιὰς	n-p---fa-	σκοπιὰ	_6	
σκοπιάς	n-p---fa-	σκοπιή	_6	
σκοτεινάς	a-p---fa-	σκοτεινός	_8	
σκοτεινὰς	a-p---fa-	σκοτεινός	_8	
σκοτίας	n-s---fg-	σκοτία	_6	
σμικρᾷ	a-p---na-	σμικρᾷ	_6	
σμικρᾶι	a-p---fn-	σμικρᾶι	_6	
σμύρνας	n-s---fg-	σμύρνα	_6	
σάς	a-p---fa-	σός	_2	
σάς	a-p---fa-	σός	_2	
σάς	a-s---fg-	σός	_2	
σὰς	a-p---fa-	σός	_2	
σὰς	a-s---fg-	σός	_2	
Σούσας	n-s---mn-	Σούση		
σοφίᾳ	n-s---fd-	σοφία	_5	
Σοφίᾳ	n-s---fd-	σοφία		
σοφίας	n-s---fg-	σοφία	_5	
σοφάς	a-p---fa-	σοφός	_4	
σοφὰς	a-p---fa-	σοφός	_4	
σπάσας	v-sapamn-	σπάζω	_5	
σπαρνάς	n-p---fa-	σπαρνή	_6	
σπαρνὰς	n-p---fa-	σπαρνή	_6	
Σπαρτιᾶτιν	n-s---fa-	Σπαρτιᾶτις	_7	
Σπαρτιᾶτις	n-s---fn-	Σπαρτιᾶτις	_7	
σπάσας	v-sapamn-	σπάσας	_5	
σπείρας	v-sapamn-	σπείρω	_6	
σπείρας	n-s---fg-	σπείρω	_6	
σπείρας	n-p---fa-	σπείρω	_6	
σπονδάς	n-p---fa-	σπονδή	_6	
σπονδάς	n-p---fa-	σπονδή	_6	
σπονδὰς	n-p---fa-	σπονδή	_6	
σπουδάσας	v-sapamn-	σπουδάδω	_8	
σταγόνας	n-p---fa-	σταγόνας	_7	
σταγόνας	n-p---fa-	σταγόνη	_7	
σταθμᾶσθαι	v--pne---	σταθμάω	_6	
σταθμήσας	v-sapamn-	σταθμήζω	_8	
στάς	v-sapamn-	σταίνω	_3	
στέγας	n-p---fa-	στέγας	_5	
στέγας	n-s---fg-	στέγη	_5	
στέγας	n-p---fa-	στέγη	_5	
στείλας	v-sapamn-	στείλω	_6	
στέρξας	v-sapamn-	στέργω	_6	
στερεάς	a-p---fa-	στερεάς	_6	
στερήσας	v-sapamn-	στερήσας	_7	
στερράς	n-p---fa-	στερρά	_6	
στερρὰς	n-p---fa-	στερρά	_6	
στεφάναν	n-s---ma-	στεφάνας	_7	
στεφάνας	n-s---fg-	στεφάνη	_7	
στιβάδας	n-p---fa-	στιβάδας	_7	
στίχας	n-p---fa-	στίξ	_5	
στίχας	n-p---fa-	στίχας	_5	
στολάς	n-p---fa-	στολή	_5	
στολάς	n-p---fa-	στολή	_5	
στολὰς	n-p---fa-	στολή	_5	
στοναχάς	n-p---fa-	στοναχή	_7	
στοναχὰς	n-p---fa-	στοναχή	_7	
στορέσας	v-sapamn-	στορέννυμι	_7	
στρατείας	n-s---fg-	στρατεία	_8	
στρατηγίας	n-s---fg-	στρατηγία	_9	
στρατηλατᾶν	n-s---ma-	στρατηλατάω	_10	
στρατηλατήσας	v-sapamn-	στρατηλατέω	_12	
στρατηλάτα	n-s---mg-	στρατηλάτης	_10	
στρατηλάταν	n-s---ma-	στρατηλάτης	_10	
στρατηλάτας	n-s---mn-	στρατηλάτης	_10	
στρατιάς	n-p---fa-	στρατιά	_7	
στρατιὰς	n-p---fa-	στρατιά	_7	
στρατιᾶς	n-s---fg-	στρατιά	_7	
στρέψας	v-sapamn-	στρέφω	_6	
στροφάς	n-p---fa-	στροφή	_6	
στροφὰς	n-p---fa-	στροφή	_6	
στροφίδας	n-p---fa-	στροφίς	_8	
στυγερᾶι	a-p---fn-	στυγερᾶι	_7	
στυγερᾶι	a-p---fd-	στυγερᾶι	_7	
στυγερᾶς	a-p---fa-	στυγερός	_7	
στυγερᾶς	a-s---fg-	στυγερός	_7	
στυγήσας	v-sapamn-	στυγήσας	_7	
στυγνάς	a-p---fa-	στυγνός	_6	
στυγνὰς	a-p---fa-	στυγνός	_6	
ὑμᾶς	p-p---ma-	σύ	_3	
ὑμᾶς	p-p----a-	σύ	_3	
ὑμᾶς	p-p---fa-	σύ	_3	
ὑμῖν	p-p---fd-	σύ	_3	
ὑμῖν	p-p----d-	σύ	_3	
ὑμῖν	p-p---md-	σύ	_3	
ὑμῖν	p2p----d-	σύ	_3	
Ὑμῖν	p-p----d-	σύ		
Ὑμῖν	p-p---md-	σύ		
συγκαθημένας	v-prpefa-	συγκαθημένας	_11	
συγκατακτάς	v-sapamn-	συγκατακτείνω	_10	
συγκατακτὰς	v-sapamn-	συγκατακτείνω	_10	
συγκῦρσαι	v--ana---	συγκῦρζω	_5	
συγχέας	v-sapamn-	συγχέλω	_6	
συγχέας	v-sapamn-	συγχέω	_6	
συγχωρούσας	v-pppafa-	συγχωράω	_10	
συλᾶι	v3saoa---	συλᾶι	_4	
συλᾶις	n-p---fd-	συλᾶις	_4	
συλᾶσθ’	v1ppip---	συλᾶσθ	_4	
συλᾶται	v3spie---	συλᾶται	_4	
συλᾶν	v--pna---	συλάω	_4	
συλᾶσθαι	v--anm---	συλάω	_4	
συλᾶσθαι	v--pne---	συλάω	_4	
συλλαβάς	n-p---fa-	συλλαβή	_7	
συλλαβὰς	n-p---fa-	συλλαβή	_7	
συμφορᾶι	n-p---fn-	συμ	_7	
συμβάς	v-sapamn-	συμβαίνω	_5	
συμβὰς	v-sapamn-	συμβαίνω	_5	
ξυμμαχίας	a-s---fg-	συμμαχία	_8	
συμμείξας	v-sapamn-	συμμείσσω	_8	
σύμπας	a-s---mn-	σύμπας	_5	
συμπήξας	v-sapamn-	συμπήγω	_7	
Συμπληγάδας	n-p---fa-	Συμπλαγάς	_10	
Συμπληγάδας	v-sapamn-	Συμπληγάδας	_10	
Συμπληγάδας	n-p---fa-	Συμπληγάς	_10	
συμπονήσας	v-sapamn-	συμπονέω	_9	
συμφορᾷ	n-s---fd-	συμφορά	_7	
συμφοράς	n-s---fg-	συμφορά	_7	
συμφοράς	n-p---fa-	συμφορά	_7	
συμφοράς	n-s---fg-	συμφορά	_7	
συμφοράς	n-p---fa-	συμφορά	_7	
συμφορὰς	n-p---fa-	συμφορά	_7	
συμφορὰς	n-s---fg-	συμφορά	_7	
συμφορᾶς	n-s---fg-	συμφορά	_7	
συμφορᾶς	n-p---fa-	συμφορά	_7	
συμφοράς	n-p---fa-	συμφορὰ	_7	
συμφορὰς	n-p---fa-	συμφορὰ	_7	
συμφορᾶι	n-p---fd-	συμφορᾶ	_7	
συμφορᾶι	n-p---fn-	συμφορᾶ	_7	
συμφορᾶι	u--------	συμφορᾶι	_7	
συμφορᾶι	n-p---fn-	συμφορᾶι	_7	
συμφορᾶι	n-s---fd-	συμφορᾶς	_7	
συμφορᾶς	n-s---fg-	συμφορᾶς	_7	
συμφυγάδας	n-p---fa-	συμφυγάς	_9	
συνᾶγε	v3siia---	συνᾶγω	_4	
ξυνᾴδει	v3spia---	συνᾴδω	_4	
συναλλαγάς	n-p---fa-	συναλλαγάς	_9	
συναμιλλᾶται	v3spie---	συναμιλλᾶται	_9	
συνάψας	v-sapamn-	συνάπτω	_6	
συναρμόσας	v-sapamn-	συναρμόζω	_9	
συναρπάσας	v-sapamn-	συναρπάζω	_9	
συνασχαλᾷ	v1sria---	συνασχαλάω	_9	
συνδαίσας	v-sapamn-	συνδαίζω	_5	
συνδήσας	v-sapamn-	συνδάω	_7	
συνδήσας	v-sapamn-	συνδέω	_7	
συνδρᾶι	v3saia---	συνδρᾶι	_6	
συνδρομάδας	n-p---fa-	συνδρομάς	_10	
συνθήκας	n-p---fa-	συνθήκη	_7	
συνναύταν	n-s---ma-	συνναύτης	_5	
συννικᾶις	v2spia---	συννικᾶις	_7	
συννοίᾳ	n-s---fd-	συννοίᾳ	_7	
συννοίας	n-p---fa-	συννοίη	_7	
συνοικίσας	v-sapamn-	συνοικίζω	_9	
συντυχίας	n-p---fa-	συντυχία	_8	
Συρίᾳ	n-s---fd-	Συρία		
σφαγάς	n-p---fa-	σφαγάς	_5	
σφαγᾶς	n-p---fa-	σφαγᾶς	_5	
σφαγάς	n-p---fa-	σφαγή	_5	
σφαγάς	n-p---fa-	σφαγή	_5	
σφαγὰς	n-p---fa-	σφαγή	_5	
σφάξας	v-sapamn-	σφάζω	_5	
σφενδόνας	n-p---fa-	σφενδόνη	_8	
σφραγῖδα	n-s---fa-	σφραγίς	_6	
σφραγῖδος	n-s---fg-	σφραγίς	_6	
σχάσας	v-sapamn-	σχάσας	_5	
σχεδίᾳ	n-s---fd-	σχεδία	_6	
σχεδίας	n-p---fa-	σχεδίη	_6	
σχετλίᾳ	a-p---nn-	σχετλίᾳ	_7	
σώσας	v-sapamn-	σώζω	_4	
σώσας	v-sapamn-	σώσας	_4	
σωτηρίᾳ	n-s---fd-	σωτηρία	_7	
σωτηρίας	n-s---fg-	σωτηρία	_7	
σωφροσύνας	n-p---fa-	σωφροσύνα	_9	
τακομένας	v-pppafa-	τακομέ	_8	
ταλαίνᾳ	a-s---fn-	ταλαίνᾳ	_4	
ταλαινᾶν	a-s---fa-	ταλαινᾶν	_4	
ταλαίνας	a-s---fg-	ταλαίνας	_4	
ταλαίνας	a-p---fa-	ταλαίνας	_4	
ταλαίνας	a-p---fa-	ταλαῖνος	_4	
τάλας	a-s---mn-	τάλας	_4	
Τάλας	a-s---mn-	τάλας	_4	
ταμίας	a-s---mn-	ταμίας	_5	
ταμίαν	a-s---ma-	ταμίης	_5	
τἀνδεᾶ	a-p---na-	τἀνδεᾶ	_6	
πταμένας	v-prpefa-	τάννυμι	_7	
Τανταλιδᾶν	a-s---fa-	Τανταλιδᾶ	_9	
τανῦν	d--------	τανῦν	_4	
Τανῦν	d--------	τανῦν		
τανύσας	v-sapamn-	τανύω	_6	
ταράξας	v-sapamn-	ταράξας	_6	
ταράς	v-sapamn-	ταράς	_4	
ταράξας	v-sapamn-	ταράσσω	_6	
ταρβήσας	v-sapamn-	ταρβέω	_7	
τάξας	v-sapamn-	τάσσω	_4	
τᾶςτυράννου	n-s---fg-	τᾶςτυράννου	_2	
ταφάς	n-p---fa-	ταφή	_4	
ταφὰς	n-p---fa-	ταφή	_4	
ταχύνας	v-sapamn-	ταχύνω	_6	
ταχείας	a-s---fg-	ταχύς	_6	
τέγξας	v-sapamn-	τέγσσω	_5	
τείσας	v-sapamn-	τείζω	_5	
τείνας	v-sapamn-	τείνω	_5	
Τειρεσία	n-s---mv-	Τειρεσία		
Τειρεσία	n-s---mv-	Τειρεσίας		
Τειρεσίας	n-s---mn-	Τειρεσίας		
Τειρεσία	n-s---mv-	τειρεσίης		
Τειρεσίαν	n-s---ma-	τειρεσίης		
τελείας	a-s---fg-	τελεῖος	_6	
τελετάς	n-p---fa-	τελετή	_6	
τελετάς	n-p---fa-	τελετή	_6	
τελετὰς	n-p---fa-	τελετή	_6	
τελευτήσας	v-sapamn-	τελευτάω	_9	
τελευτάς	n-p---fa-	τελευτή	_7	
τελευτάς	n-p---fa-	τελευτή	_7	
τελευτὰς	n-p---fa-	τελευτή	_7	
τελευτώσας	v-sapamn-	τελευτόω	_9	
τελέσας	v-sapamn-	τελέω	_6	
τελουμένας	v-pppefa-	τελουμένας	_9	
τέρας	n-s---nn-	τέρας	_4	
τέρας	n-s---na-	τέρας	_4	
τερπνάς	a-p---fa-	τερπνός	_6	
τερπνὰς	a-p---fa-	τερπνός	_6	
τεύξας	v-sapamn-	τεύκω	_5	
τέχνας	n-s---fg-	τέχνη	_5	
τέχνας	n-p---fa-	τέχνη	_5	
Τηρεΐας	v-pppafa-	Τηρεΐας		
τηρήσας	v-sapamn-	τηρέω	_6	
τιήρας	n-s---fg-	τιήρη	_5	
τιθήνας	n-s---fg-	τιθήνη	_6	
τιμᾶ	v2spma---	τιμᾶ	_4	
τιμᾶ	u--------	τιμᾶ	_4	
τιμᾶι	n-p---fn-	τιμᾶ	_4	
τιμᾶι	v3spia---	τιμᾶι	_4	
τιμᾶις	n-p---fd-	τιμᾶις	_4	
τιμαλφουμένας	v-pppefa-	τιμαλφουμένας	_12	
τιμᾶν	v--pna---	τιμᾶν	_4	
τιμάς	n-p---fa-	τιμάς	_4	
ἐτίμα	v3siia---	τιμάω	_5	
τιμᾷ	v3spia---	τιμάω	_4	
τίμα	v2spma---	τιμάω	_4	
τιμᾶν	v--pna---	τιμάω	_4	
τιμᾷς	n-p---fa-	τιμάω	_4	
τιμᾷς	v2spia---	τιμάω	_4	
τιμᾶσθαι	v--pne---	τιμάω	_4	
τιμᾶτε	v2ppma---	τιμάω	_4	
τιμήσας	v-sapamn-	τιμάω	_6	
τιμάς	n-p---fa-	τιμή	_4	
τιμάς	n-p---fa-	τιμή	_4	
τιμὰς	n-p---fa-	τιμή	_4	
τιμώσας	v-sapamn-	τιμόω	_6	
τινάς	a-p---fa-	τινάς	_4	
τινάξας	v-sapamn-	τινάσσω	_6	
τίνας	a-p---fa-	τίς	_4	
Τιτᾶνα	n-s---ma-	Τιτᾶν	_4	
Τιτᾶνι	n-s---md-	Τιτᾶν		
Τιτᾶνας	n-p---ma-	Τιτᾶνης	_4	
τίτας	n-p---fa-	τίτη	_4	
τλάς	a-p---fa-	τλάς	_3	
τλάς	a-s---mn-	τλάς	_3	
τλὰς	a-p---fa-	τλὰς	_3	
τλάσας	v-sapamn-	τλάσω	_5	
τλατᾶς	a-p---fa-	τλατᾶς	_5	
τοξότας	n-p---fa-	το	_6	
τοίας	a-p---fa-	τοῖος	_4	
τοιαύτας	a-p---fa-	τοιοῦτος	_4	
τόλμα	v2spma---	τόλμα	_5	
ἐτόλμα	v3siia---	τολμάω	_6	
ἐτόλμας	v2siia---	τολμάω	_6	
τολμήσας	v-sapamn-	τολμάω	_7	
τολμώσας	v-pppafa-	τολμάω	_7	
τολυπεύσας	v-sapamn-	τολυπεύσας	_9	
τομάς	n-p---fa-	τομά	_4	
τοξεύσας	v-sapamn-	τοξεύω	_7	
τοξοδάμας	n-s---mn-	τοξοδάμας	_8	
Τραχῖνι	n-s---fd-	τραχίς	_5	
τρέσας	v-sapamn-	τρέσας	_5	
τρέσας	v-sapamn-	τρέω	_5	
τριαίνας	n-p---fa-	τριαίνη	_4	
τριακάδας	n-p---fa-	τριακάς	_8	
τριβᾶς	n-p---fa-	τριβᾶς	_5	
τριβᾷ	n-s---fd-	τριβή	_5	
τριβάς	n-p---fa-	τριβή	_5	
τριβὰς	n-p---fa-	τριβή	_5	
τριπλᾶ	a-p---na-	τριπλᾶ	_6	
τριπλᾶ	a-p---nn-	τριπλᾶ	_6	
τρισμυρίας	a-p---fa-	τρισμύριοι	_9	
Τρισσάς	a-p---fa-	Τρισσάς		
Τροζηνίας	n-p---fa-	Τροζηνία		
Τροζηνίας	n-s---fg-	Τροζηνία		
Τροζηνίας	n-p---fa-	Τροζηνίη		
Τροίας	n-s---fg-	τροία		
Τροΐας	n-s---fg-	Τροΐα		
Τροίας	n-s---fg-	Τροίας		
τροπάς	n-p---fa-	τροπή	_5	
τροπὰς	n-p---fa-	τροπή	_5	
τροφάς	n-p---fa-	τροφάς	_5	
τροφάς	n-p---fa-	τροφή	_5	
τροφάς	n-p---fa-	τροφή	_5	
τροφὰς	n-p---fa-	τροφή	_5	
τρυφᾶι	v3spia---	τρυφᾶι	_5	
τρυφᾶν	v--pna---	τρυφάω	_5	
τρυφάς	n-p---fa-	τρυφή	_5	
τρυφάς	n-p---fa-	τρυφή	_5	
τρυφὰς	n-p---fa-	τρυφή	_5	
Τρωιάς	a-p---fa-	Τρωιάς		
Τρωιάς	n-p---fa-	Τρωιάς		
Τρωιὰς	n-p---fa-	Τρωιὰς		
Τρωίας	a-p---fa-	Τρωίας		
Τρωϊκάς	a-p---fa-	Τρωϊκάς		
Τρωίας	a-p---fa-	Τρωῖος		
τυχούσας	v-sapafg-	τυγχάνω	_7	
Τυνδαρείας	a-s---fg-	Τυνδαρεία	_9	
Τυρίας	n-p---fa-	Τυρίη		
τυφλάς	a-p---fa-	τυφλός	_5	
τυφλὰς	a-p---fa-	τυφλός	_5	
τυφλώσας	v-sapamn-	τυφλώσας	_7	
τύχᾳ	n-p---nn-	τύχᾳ	_4	
τύχαν	v2spma---	τύχαν	_4	
τύχα	n-s---mv-	τύχας	_4	
τύχας	n-p---fa-	τύχας	_4	
τυχαςἅ	n-s---fg-	τυχαςἅ	_6	
τυχάς	n-p---fa-	τυχή	_4	
τυχὰς	n-p---fa-	τυχή	_4	
τύχᾳ	n-s---fa-	τύχη	_4	
τύχᾳ	n-s---fn-	τύχη	_4	
τύχᾳ	n-s---fd-	τύχη	_4	
τύχας	n-p---fa-	τύχη	_4	
τύχας	n-s---fg-	τύχη	_4	
ὑγιείας	n-s---fg-	ὑγιεία	_6	
ὑγιείας	n-s---fg-	ὑγιείας	_6	
ὑγρᾶς	a-s---fg-	ὑγρός	_4	
ὕδρας	n-p---fa-	ὕδρα	_4	
ὕδρας	n-s---fg-	ὕδρα	_4	
ὑδρηλάς	n-p---fa-	ὑδρηλή	_6	
ὑδρηλὰς	n-p---fa-	ὑδρηλή	_6	
ὑλᾶντα	n-p---na-	ὑλᾶν	_3	
ὕλας	n-p---fa-	ὕλας	_3	
ὑλᾶεν	a-s---nn-	ὑλήεις	_3	
ὑμᾶς	u--------	ὑμᾶς	_3	
ὑμᾶς	p-p---ma-	ὑμεῖς	_3	
ὑμᾶς	p2p----a-	ὑμεῖς	_3	
ὑμᾶς	p-p----a-	ὑμεῖς	_3	
ὑμᾶς	p-p---fa-	ὑμεῖς	_3	
ὑμῖν	p-p----d-	ὑμεῖς	_3	
ὑμῖν	p-p---md-	ὑμεῖς	_3	
ὑμῖν	p2p----d-	ὑμεῖς	_3	
ὑμετέρας	a-p---fa-	ὑμέτερος	_7	
ὑπαιθρίας	a-s---fg-	ὑπαιθρῖος	_3	
ὑπαλλαγάς	n-p---fa-	ὑπαλλαγή	_8	
ὑπαλλαγὰς	n-p---fa-	ὑπαλλαγή	_8	
ὑπαντήσας	v-sapamn-	ὑπαντήω	_8	
ὑπεκβᾶσ’	v-sapafn-	ὑπεκβᾶσ	_6	
ὑπεράρας	v-sapamn-	ὑπεραίρω	_7	
ὑπερβάς	v-sapamn-	ὑπερβαίνω	_6	
ὑπερβὰς	v-sapamn-	ὑπερβαίνω	_6	
ὑπερβαλλούσας	v-pppafa-	ὑπερβαλλούσας	_12	
ὑπερβολάς	n-p---fa-	ὑπερβολή	_8	
ὑπερποντίας	a-s---fg-	ὑπερποντίας	_10	
ὑπερτείνας	v-sapamn-	ὑπερτείνω	_9	
ὑπερτέρας	a-s---fg-	ὑπέρτερος	_8	
ὑπερφρονήσας	v-sapamn-	ὑπερφρονέω	_11	
ὑπνοδόταν	n-s---ma-	ὑπνοδότης	_8	
ὑποκάμψας	v-sapamn-	ὑποκάμπτω	_8	
ὑπόπταν	a-s---ma-	ὑπόπταν	_6	
ὑποπτήξας	v-sapamn-	ὑποπτήγω	_8	
ὑποπτήξας	v-sapamn-	ὑποπτήσσω	_8	
ὑποσπάσας	v-sapamn-	ὑποσπάω	_8	
ὑποστρέψας	v-sapamn-	ὑποστρέφω	_9	
ὑπουργίας	n-s---fg-	ὑπουργία	_8	
Ὑσιάς	n-p---fa-	ὑσιαί		
Ὑσταίχμας	n-s---mn-	Ὑσταίχμας		
ὑστάτας	a-p---fa-	ὑστάτας	_6	
ὑστέρας	a-p---fa-	ὕστερος	_6	
ὑφάς	n-p---fa-	ὑφή	_3	
ὑποστάς	v-sapamn-	ὑφίστημι	_6	
ὑποστὰς	v-sapamn-	ὑφίστημι	_6	
ὑποστήσας	v-sapamn-	ὑφίστημι	_8	
Φάμα	v2spma---	Φά	_4	
φαεννάς	n-p---fa-	φαεν	_6	
φαεννὰς	n-p---fa-	φαεν	_6	
φαεννάς	a-p---fa-	φαεννάς	_6	
φαεννὰς	a-p---fa-	φαεννὰς	_6	
φαεννάς	a-p---fa-	φαεννός	_6	
φαεννὰς	a-p---fa-	φαεννός	_6	
Φαίδρας	n-s---fg-	Φαίδρας		
Φαίδρας	n-s---fg-	Φαίδρη		
φαμένας	v-sppefg-	φαμένας	_6	
φανάς	v-sapamn-	φανάς	_4	
φανὰς	v-sapamn-	φανὰς	_4	
φανείσας	v-sapafg-	φανείσας	_7	
Φαρσαλίας	a-p---fa-	Φαρσαλία	_8	
Φαρσαλίας	n-s---fg-	Φαρσαλία	_8	
φατίσας	v-sapamn-	φατίζω	_6	
φάτνας	n-p---fa-	φάτνη	_5	
φαυλοτέρας	a-s---fgc	φαυέρτλοος	_2	
Φεραίας	a-s---fg-	Φεραίη		
Φερητιάδας	n-s---mn-	Φερητιάδης	_9	
φερνάς	n-p---fa-	φερνή	_5	
φερνάς	n-p---fa-	φερνή	_5	
φερνὰς	n-p---fa-	φερνή	_5	
φερνάς	a-p---fa-	φερνός	_5	
φερνὰς	a-p---fa-	φερνός	_5	
φερούσας	v-pppafa-	φερούσας	_7	
φερούσας	v-pppafa-	φέρω	_7	
φήμας	n-p---fa-	φήμη	_4	
φθάσας	v-sapamn-	φθάνω	_5	
Ἐφθαρμένας	v-prpefa-	φθείρω	_9	
Φθιάς	n-p---fa-	Φθιά		
Φθιάς	n-s---fg-	Φθιὰ		
Φθιὰς	n-s---fg-	Φθιὰ		
Φθίας	n-s---fg-	Φθία		
Φθίας	n-p---fa-	Φθία		
φθιμένας	v-pppefa-	φθιμένας	_7	
φθίσας	v-sapamn-	φθίω	_5	
Φθιωτᾶν	n-s---fa-	Φθιωτᾶν		
Φθιωτίδας	n-s---fg-	Φθιωτίδα		
φθογγάς	n-p---fa-	φθογγή	_6	
φθογγάς	n-p---fa-	φθογγή	_6	
φθογγὰς	n-p---fa-	φθογγή	_6	
φθονήσας	v-sapamn-	φθονέω	_7	
φθοράς	n-p---fa-	φθορά	_5	
φθορὰς	n-p---fa-	φθορά	_5	
φιάλας	n-p---fa-	φιάλας	_5	
φίλᾳ	a-p---na-	φίλᾳ	_4	
φιλᾶν	a-s---fa-	φιλᾶν	_4	
φιλίας	n-p---fa-	φιλία	_5	
φιλίας	n-s---fg-	φιλία	_5	
φιλίας	n-s---fg-	φιλῖα	_5	
φίλας	a-s---fg-	φίλος	_4	
φίλας	a-p---fa-	φίλος	_4	
Φιλοτιμίας	n-s---fg-	φιλοτιμία		
Φινεΐδας	n-s---mn-	Φινεΐδαι		
φιτῦσαι	v--ana---	φιτῦζω	_4	
φιτύσας	v-sapamn-	φιτύω	_6	
φλογεράν	a-s---ma-	φλογερὰς	_7	
φλογερὰν	a-s---ma-	φλογερὰς	_7	
φλογέας	a-p---fa-	φλογύς	_6	
φόβας	n-p---fa-	φόβη	_4	
Φοινίσσας	n-p---fa-	Φοῖνιξ		
φοινίας	a-s---fg-	φοίνιος	_6	
φοινίας	a-p---fa-	φοίνιος	_6	
φονεύσας	v-sapamn-	φονεύω	_7	
φονίᾳ	a-p---na-	φονῖος	_5	
φονίας	n-p---fa-	φονῖος	_5	
φονίας	a-s---fg-	φονῖος	_5	
φονίας	a-p---fa-	φονῖος	_5	
φορβάν	v2spma---	φορβάν	_5	
φορβὰν	v2spma---	φορβὰν	_5	
φορβάν	n-s---ma-	φορβή	_5	
φορβὰν	n-s---ma-	φορβή	_5	
Φόρβας	n-p---fa-	Φόρβη		
φράσας	v-sapamn-	φράζω	_5	
φράσας	v-sapamn-	φράσας	_5	
φρένας	n-p---fa-	φρένας	_5	
φρένας	n-p---fa-	φρήν	_5	
φρίξας	v-sapamn-	φρίζω	_5	
φρονήσας	v-sapamn-	φρονέω	_7	
φροντίσας	v-sapamn-	φροντίζω	_8	
φροντίδας	n-p---fa-	φροντίς	_8	
φρουρήσας	v-sapamn-	φρουρέω	_8	
Φρυγίας	n-s---fg-	Φρυγία		
φρυκτωρίας	n-s---fg-	φρυκτωρία	_9	
φυγᾶς	n-s---fg-	φυγᾶ	_4	
φυγᾷ	u--------	φυγᾷ	_4	
φυγᾷ	d--------	φυγᾷ	_4	
φυγᾷ	n-s---fa-	φυγᾷ	_4	
φυγᾶι	n-p---fn-	φυγᾶι	_4	
φυγάδας	n-p---fa-	φυγάς	_6	
φυγάς	n-p---fa-	φυγάς	_4	
φυγᾶι	n-p---fn-	φυγᾶς	_4	
φυγᾶς	n-p---fa-	φυγᾶς	_4	
φυγᾷ	n-s---ma-	φυγᾷς	_4	
φυγάς	n-p---fa-	φυγή	_4	
φυγάς	n-s---mn-	φυγή	_4	
φυγάς	n-s---fg-	φυγή	_4	
φυγὰς	n-p---fa-	φυγή	_4	
φυγὰς	n-s---mn-	φυγή	_4	
φυγὰς	n-s---fg-	φυγή	_4	
φυγᾶς	n-s---fg-	φυγή	_4	
φυγούσας	v-pppafa-	φυγούσας	_7	
φυλακᾷ	n-s---ma-	φυλακᾷ	_6	
φυλακᾶς	n-p---fa-	φυλακᾶς	_6	
φυλακάς	n-p---fa-	φυλακή	_6	
φυλακάς	n-p---fa-	φυλακή	_6	
φυλακὰς	n-p---fa-	φυλακή	_6	
φυλάξας	v-sapamn-	φυλάσσω	_6	
φυλλάς	n-s---fg-	φυλλὰ	_5	
φυλλὰς	n-s---fg-	φυλλὰ	_5	
φυξανορίᾳ	n-s---ma-	φυξανορίᾳ	_9	
φύσας	n-p---fa-	φῦσα	_4	
φυσᾶις	v2sfia---	φυσᾶις	_4	
φύσας	v-sapamn-	φύσας	_4	
φυσιᾷ	n-s---fa-	φυσιάω	_5	
φυτεύσας	v-sapamn-	φυτεύω	_7	
φύσας	v-sapamn-	φύω	_4	
φωνάς	n-p---fa-	φωνή	_4	
φωνὰς	n-p---fa-	φωνή	_4	
χαίτας	n-p---fa-	χαί	_2	
χαίτας	n-p---fa-	χαίτη	_2	
χάλα	v2spma---	χάλα	_4	
χαλάσας	v-sapamn-	χαλάζω	_6	
χαλᾶι	v3spia---	χαλᾶι	_4	
χαλᾶι	n-s---fd-	χαλᾶι	_4	
χαλᾶτε	v2ppma---	χαλᾶτε	_4	
χαλᾷ	v3spia---	χαλάω	_4	
χαλᾶν	v--pna---	χαλάω	_4	
χαλᾷς	v2spia---	χαλάω	_4	
χαλᾶτε	v2ppma---	χαλάω	_4	
Χαλᾶτε	v2ppma---	χαλάω	_4	
Χαλᾶν	v--pna---	Χαλάω	_4	
χαλεπᾶι	a-p---fn-	χαλεπᾶι	_6	
χαλεπᾶς	a-p---fa-	χαλεπός	_6	
χαλκέας	a-p---fa-	χαλκής	_6	
χαλκοβόαν	n-s---ma-	χαλκοβόας	_8	
χαμᾶζε	d--------	χαμᾶζε	_4	
χαμεύνας	n-p---fa-	χαμεύ	_7	
χαμεύνας	n-p---fa-	χαμεύνη	_7	
χαρᾷ	n-s---fd-	χαρά	_4	
χαρᾶς	n-s---fg-	χαρά	_4	
χαρᾶι	n-p---fn-	χαρᾶ	_4	
χαρᾶι	n-p---fd-	χαρᾶ	_4	
χαρᾶι	n-s---nd-	χαρᾶ	_4	
χαρᾶι	n-s---fd-	χαρᾶι	_4	
χαρμονᾶν	n-s---fa-	χαρμονᾶν	_7	
χαρμονάς	n-p---fa-	χαρμονάς	_7	
χἀρπαγάς	n-p---fa-	χἀρπαγή	_7	
χἀρπαγὰς	n-p---fa-	χἀρπαγή	_7	
χἀτέρᾳ	a-p---nac	χἀτέρᾳ	_6	
χέρας	n-p---fa-	χείρ	_4	
χειρωναξίας	n-p---fa-	χειρωναξίας	_10	
χεούσας	v-pppafa-	χεούσας	_6	
χέρας	n-p---fa-	χέρας	_4	
χερμάδας	n-p---fa-	χερμάς	_7	
χεροτεκτοσύνας	n-p---fa-	χεροτεκτοσύνη	_13	
χηλάς	n-p---fa-	χηλή	_4	
χηλὰς	n-p---fa-	χηλή	_4	
χθονίας	a-s---fg-	χθονῖος	_6	
Χθονίας	a-p---fa-	Χθονῖος		
χιλιάς	a-p---fa-	χιλιάς	_5	
χιλιὰς	a-p---fa-	χιλιὰς	_5	
χιλιοναύταν	n-s---ma-	χιλιοναύτης	_7	
χιμαίρας	n-p---fa-	χιμαίρη	_4	
χλιδάς	n-p---fa-	χλιδά	_5	
χλιδᾶν	n-s---fa-	χλιδᾶ	_5	
χλιδᾶς	n-s---fg-	χλιδᾶ	_5	
χλιδᾷ	n-s---fn-	χλιδᾷ	_5	
χλιδᾷς	v2spia---	χλιδάω	_5	
χνας	n-p---fa-	χνη	_3	
χνόας	n-p---fa-	χνόας	_4	
χνόας	n-p---fa-	χνόη	_4	
χοάς	n-p---fa-	χοάς	_3	
χοάς	n-p---fa-	χοή	_3	
χοάς	n-p---fa-	χοή	_3	
Χοάς	n-p---fa-	χοή		
χοὰς	n-p---fa-	χοή	_3	
Χοὰς	n-p---fa-	χοή		
χορεύσας	v-sapamn-	χορεύω	_7	
χἀτέρας	a-p---fa-	χότερἀς	_6	
χρείας	n-p---fa-	χρεία	_5	
χρείας	n-s---fg-	χρεία	_5	
χρείας	n-s---fg-	χρείας	_5	
χρήσας	v-sapamn-	χρήδω	_5	
χρηστάς	a-p---fa-	χρηστός	_6	
χρηστὰς	a-p---fa-	χρηστός	_6	
χρήσας	v-sapamn-	χρήω	_5	
χρονίᾳ	a-p---na-	χρονία	_6	
χρονίας	a-p---fa-	χρονίας	_6	
χρυσέας	a-s---fg-	χρύσεος	_6	
χρυσέας	a-p---fa-	χρύσεος	_6	
χρυσοκόμας	a-s---mn-	χρυσοκόμας	_9	
χρυσομίτραν	n-s---ma-	χρυσομίτρας	_10	
χὐμῖν	n-s---fn-	χὐμῖα	_4	
χώρας	n-s---fg-	χώρα	_4	
Χώρας	n-s---fg-	χώρα		
χωρίσας	v-sapamn-	χωρίζω	_6	
ψαμμίας	n-p---fa-	ψαμμία	_6	
ψαύσας	v-sapamn-	ψαύω	_2	
ψαφαρᾷ	n-s---fa-	ψαφαρᾷ	_6	
ψεύσας	v-sapamn-	ψεύω	_5	
ψυχᾶι	n-p---fn-	ψυχᾶ	_4	
ψυχᾶι	n-p---fv-	ψυχᾶ	_4	
ψυχᾶι	n-p---fn-	ψυχᾶι	_4	
ψυχᾶς	u--------	ψυχᾶς	_4	
ψυχᾷ	n-s---fd-	ψυχή	_4	
ψυχάς	n-p---fa-	ψυχή	_4	
ψυχὰς	n-p---fa-	ψυχή	_4	
ψυχᾶς	n-p---fa-	ψυχή	_4	
ψυχᾶς	n-s---fg-	ψυχή	_4	
ᾠδάς	n-p---fa-	ᾠδάς	_3	
ὠιδάς	n-p---fa-	ὠιδάς	_4	
ὠιδάς	n-p---fa-	ὠιδάς	_4	
ὠιδὰς	n-p---fa-	ὠιδὰς	_4	
ὠινωμένας	v-prpefa-	ὠινωμένας	_8	
ὠκιστᾶν	v3paia---	ὠκιστᾶν	_6	
ὠκυπέτᾳ	a-p---na-	ὠκυπέτᾳ	_7	
ὠλένας	n-p---fa-	ὠλένη	_5	
ὥρας	n-p---fa-	ὥρα	_3	
ὥρας	n-s---fg-	ὥρα	_3	
ὠφελήσας	v-sapamn-	ὠφελάω	_7	
