ἀκροιςφρουράν	a-s---fa-	ἄκροιςφρουρή
=>
ἄκροις	a-s---fa-	ἄκρος
φρουράν	a-s---fa-	φρουρή

ἀπαιςἐγώ	u--------	ἀπαιςἐγώ
ἄπαιςἐγω	u--------	ἄπαιςἐγὼ
ἀπαλλάςσουσα	n-s---fg-	ἀπαλλάς
ἀποφάςκονθ’	v-sppama-	ἀποφάς
ἀπρόςδεικτος	a-s---fn-	ἀπρός
Ἀρηςτιθασός	a-s---mn-	Ἀρηςτιθασός
Ἄρηςτιθασὸς	a-s---mn-	Ἄρηςτιθασὸς
ἀρίςτα	n-p---nn-	ἀρίς
αὑτᾶςἔτλας	a-p---fa-	αὑτᾶςἔτλας
ἄχοςἀβίοτον	n-s---na-	ἄχοςἀβίοτος
γυναικός’	u--------	γυναικός’
διςσάρχας	d--------	δις
διςσούς	a-p---ma-	δις
διςσοὺς	a-p---ma-	δις
διςσῶν	d--------	δις
δυςδαιμόνων	m--------	δυς
δύςοιστον	m--------	δύς
ἔβλαςτε	v2saia---	ἔβλας
εἱλιςσομένας	n-s---fg-	εἱλις
ἑκατογκεφάλοιςὄφεων	a-p---fd-	ἑκατογκεφάλοιςὄφεων
Ἐλπίδοςἄμβροτε	a-s---fv-	Ἐλπίδοςἄμβροτε
ἐπιβούλους’	a-p---fa-	ἐπιβούλους
ἔρεξαςἤδη	v2saia---	ἔρεξαςἤδη
εὐίππουςὄχους	a-p---ma-	εὐίππουςὄχους
ζωναςκαί	a-p---fa-	ζωναςκαί
ζώναςκαι	a-p---fa-	ζώναςκαὶ
ἥσυχοςκἀκεῖνο	a-s---mn-	ἥσυχοςκἀκεῖνό
ἴςχων	n-s---fa-	ἴς
κακοῖςθρασυ	a-p---nd-	κακοῖςθρασύ
κακοτυχεῖςγυναικων	a-p---fv-	κακοτυχεῖςγυναικῶν
καλαμοεςσᾶν	n-p---fn-	καλαμος
κἀναστήσειςφοιτάδα	v2sfia---	κἀναστήσειςφοιτάς
κεχυμένοςἐπαντέλλει	v3spia---	κεχυμένοςἐπαντέλλω
κιςσόν	n-s---ma-	κις
κιςσὸν	n-s---ma-	κις
κιςσοφόροις	v-sapamn-	κις
λύμαιςνέοι	n-p---fd-	λύμαιςνέοι
μελιςσᾶν	n-s---fa-	μελιςτον
μέλοςἈίδα	v1sria---	μέλοςἈίδα
νᾶεςπανωλέθροισιν	a-p---fd-	νᾶεςπανωλέθροισιν
οἰωνὸςμέγας	n-p---ma-	οἰωνὸςμέγας
ὁμοΐωςμαυροῦμεν	v1ppia---	ὁμοΐωςμαυροεῦμι
ὀνησαςκαλόν	v-sapamn-	ὀνήσαςκαλός
ὀνήσαςκαλον	v-sapamn-	ὀνήσαςκαλός
ὀρφανιεῖςἀλλ’	v2spia---	ὀρφανιεῖςἀλλ
ὀρφανοὺςδόμους	a-p---ma-	ὀρφανοὺςδόμους
Πατρός’	n-s---mg-	πατήρ
Πατρὸς’	n-s---mg-	πατήρ
πημανούμενος»	v-sfpmmn-	πημανούμενος»
πόλιςμα	n-s---fn-	πόλις
ποταναῖςἀγέλαις	n-p---fd-	ποταναῖςἀγέλη
πραςσομένα	v-pppana-	πρας
πράςσοντας	v-pppama-	πράς
σταλάςσουσ’	v-sapamn-	σταλάς
στυγηθεὶςτέκνοις	v-sappmn-	στυγηθεὶςτέκνοις
τανυδρόμοιςκῶλα	a-p---fd-	τανυδρόμοιςκῶλα
τᾶςτυράννου	n-s---fg-	τᾶςτυράννου
τιναςφίλους	a-p---ma-	τιναςφίλους
τιςπαρθένος	n-s---fn-	τιςπαρθένος
τυχαςἅ	n-s---fg-	τυχαςἅ
τύχαςα	n-s---fg-	τύχαςἃ
φθισαςτάν	v-sapamn-	φθισαςτάν
φθίσαςταν	v-sapamn-	φθίσαςτὰν
φθονήσῃςεὐγμάτων	n-p---ng-	φθονήσῃςεὐγμάτων
φυγὰςξυμπέφρασται	v3srie---	φυγὰςξυμπέφρασται
φυλάςσων	n-p---fa-	φυλή
χαριςἙλλάς	n-s---fn-	χαριςἙλλάς
χάριςἑλλας	n-s---fn-	χάριςἙλλὰς
