ἁβρότητ	n-s---fa-	ἁβρότητ
ἄγ	c--------	ἄγ
ἄγ	d--------	ἄγ
ἄγ	v2spma---	ἄγ
Ἄγ	d--------	Ἄγ
ἂγ	v2spma---	ἂγ
ἄγαγ	v3saia---	ἄγαγ
ἀγάγετ	v3saim---	ἀγάγετ
ἀγάγετ’	v2pama---	ἀγάγετ’
ἀγάθ	d--------	ἀγάθ
ἀγάθ	a-p---na-	ἀγάθ
ἀγάλ	n-p---na-	ἀγάλ
ἄγαλμ	d--------	ἄγαλμ
ἄγαλμ	a-p---na-	ἄγαλμ
ἄγαλμ’	u--------	ἄγαλμ’
ἀγάλμαθ	n-p---na-	ἀγάλμαθ
ἀγάλμαθ	n-p---nn-	ἀγάλμαθ
ἀγάλματ	n-p---na-	ἀγάλματ
ἀγάλματ	n-p---nn-	ἀγάλματ
ἀγάμεθ	v2srma---	ἀγάμεθ
ἀγάμεθ	n-s---mv-	ἀγάμεθ
ἀγγείλατ	v2pama---	ἀγγείλατ
ἄγγελλ	a-s---mv-	ἄγγελλ
ἄγγελλ	n-p---na-	ἄγγελλ
ἀγγέλλουσ	v-sppafn-	ἀγγέλλουσ
ἄγγελμ	n-s---na-	ἄγγελμ
ἀγείρασ	v-sapafn-	ἀγείρασ
ἄγετ	v2ppma---	ἄγετ
ἀγκαλέσαιτ	v3saom---	ἀγκαλέσαιτ
ἀγλάισμ	n-s---na-	ἀγλάισμ
ἄγ	v2spma---	ἄγμι
ἅγνευμ	n-s---na-	ἅγνευμ
ἀγνῶθ	a-s---ma-	ἀγνῶθ
ἀγνῶτ	n-s---ma-	ἀγνῶτ
ἀγνῶτ	a-s---ma-	ἀγνῶτ
ἄγοιμ	v1spoa---	ἄγοιμ
Ἄγοιτ	v2ppoa---	Ἄγοιτ
ἄγοντ	v-sppama-	ἄγοντ
ἄγουσ	v-sppafn-	ἄγουσ
ἅγ	n-s---na-	ἅγς
ἄγ	d--------	ἄγτε
ἀγυιᾶτ	v2piia---	ἀγυιᾶτ
ἅγωγ	d--------	ἅγωγ
ἀγῶν’	n-s---ma-	ἀγῶν’
ἀγώνισμ	n-s---nn-	ἀγώνισμ
ἅδ	p-s---fn-	ἅδ
ἅδ	d--------	ἅδ
ἀδάματ	a-p---na-	ἀδάματ
ἀδέλφ	n-p---na-	ἀδέλφ
ἄδικ	a-p---na-	ἄδικ
ἀδικούμεθ	v1ppie---	ἀδικούμεθ
Ἄδμηθ	a-s---mv-	Ἄδμηθ
Ἄδμητ	a-s---mv-	Ἄδμητ
Ἄδμητ	n-s---mv-	Ἄδμητ
ἀδόκιμ	a-p---na-	ἀδόκιμ
Ἄδρασθ	a-p---na-	Ἄδρασθ
Ἄδραστ	a-p---na-	Ἄδραστ
Ἄδραστ	a-s---mv-	Ἄδραστ
ἀδύνατ	v2pama---	ἀδύνατ
ἄεθλ	n-p---na-	ἄεθλ
ἀείδεθ	v3spie---	ἀείδεθ
ἀείδουσ	v-sppafn-	ἀείδουσ
Ἀείρομ	v1spie---	Ἀείρομ
ἀελ	n-p---fn-	ἀελ
ἀέλ	n-p---fn-	ἀέλ
ἄεπτ	n-p---na-	ἄεπτ
ἅζονθ	v-sppama-	ἅζονθ
ἀθρήσαθ	v2pama---	ἀθρήσαθ
ἄθροισμ	n-p---na-	ἄθροισμ
ἀθυμήσαντ	v-sapama-	ἀθυμήσαντ
αἰάζουσ’	v-sppafn-	αἰάζουσ’
Αἴαντ	n-s---ma-	Αἴαντ
αἰγίδ	n-s---fa-	αἰγίδ
Αἴγισθ	n-s---mv-	Αἴγισθ
Αἵδ	d--------	Αἵδτε
αἴκισμ	a-s---nn-	αἴκισμ
αἱμάσσουσ	v3ppia---	αἱμάσσουσ
αἵματ	n-p---na-	αἵματ
αἰνέσατ	v3saim---	αἰνέσατ
αἴνιγμ	n-s---nn-	αἴνιγμ
αἴνιγμ	n-s---na-	αἴνιγμ
αἰνίγματ	n-p---na-	αἰνίγματ
Αἴρετ	v2ppma---	Αἴρετ
ἄϊσσ	d--------	ἄϊσσ
αἴσχισθ	a-p---nas	αἴσχισθν
αἴσχιστ	a-p---na-	αἴσχιστ
αἴσχιστ	a-p---nn-	αἴσχιστ
αἴσχυν’	v2spma---	αἴσχυν’μι
αἰσχύνασ	v-sapafn-	αἰσχύνασ
αἰσχύνοιτ	v3spoe---	αἰσχύνοιτ
αἰσχύνουσ	v-sppafn-	αἰσχύνουσ
Αἰτωλίδ	n-s---fa-	Αἰτωλίδ
αἰχμάλωθ	a-p---nn-	αἰχμάλωθ
ἀκ	n-p---na-	ἀκ
ἄκλαυτ	a-p---na-	ἄκλαυτ
ἄκληιστ	a-p---na-	ἄκληιστ
ἀκόλαστ	a-p---na-	ἀκόλαστ
ἄκονθ	a-s---ma-	ἄκονθ
ἄκονθ’	a-s---ma-	ἄκονθ’
ἄκοντ	n-s---ma-	ἄκοντ
ἀκοντίζουσ	v-pppafn-	ἀκοντίζουσ
ἀκούεθ	v3spoe---	ἀκούεθ
Ἀκούεθ	v2ppia---	Ἀκούεθ
ἀκούετ	v3siie---	ἀκούετ
ἀκούετ	v2ppia---	ἀκούετ
ἀκούουσ	v-pppafn-	ἀκούουσ
ἄκουσ’	u--------	ἄκουσ’
ἀκούσαθ	v2pama---	ἀκούσαθ
ἀκούσαθ’	v2pama---	ἀκούσαθ’
ἀκούσαιμ	v1saoa---	ἀκούσαιμ
ἀκούσαντ	v-sapama-	ἀκούσαντ
ἀκούσασ	v-sapafn-	ἀκούσασ
ἀκούσασ’	v-sapafn-	ἀκούσασ’
ἀκούσατ’	v2pama---	ἀκούσατ’
ἀκούσεσθ	v2pfim---	ἀκούσεσθ
ἄκουσμ	n-s---na-	ἄκουσμ
ἄκρανθ	d--------	ἄκρανθτε
ἄκραντ	a-s---ma-	ἄκραντ
ἄκραντ	a-p---na-	ἄκραντ
ἀλ	n-s---mg-	ἀλ
ἀλ	a-s---fg-	ἀλ
ἄλ	a-s---mn-	ἄλ
ἄλ	d--------	ἄλ
ἄλ	n-s---na-	ἄλ
ἄλ	n-s---ma-	ἄλ
ἄλ	n-p---mg-	ἄλ
ἅλ	p-s---fa-	ἅλ
ἅλαδ	d--------	ἅλαδ
ἀλαίνοντ	v-pppana-	ἀλαίνοντ
ἄλαστ	a-p---na-	ἄλαστ
ἀλγήμαθ	n-p---na-	ἀλγήμαθ
ἀλγήσετ	v2pasa---	ἀλγήσετ
ἄλγιστ	a-p---na-	ἄλγιστ
ἄλγιστ	a-p---nn-	ἄλγιστ
ἀλέξημ	n-s---nn-	ἀλέξημ
ἀληθεύσαιμ	v1saoa---	ἀληθεύσαιμ
ἀλιτόντ	v-sppama-	ἀλιτόντ
ἀλλ	c--------	ἀλλ
ἀλλ	u--------	ἀλλ
ἀλλ	a-p---na-	ἀλλ
Ἀλλ	c--------	Ἀλλ
ἄλλ	a-s---na-	ἄλλ
ἄλλ	a-p---na-	ἄλλ
ἄλλ	d--------	ἄλλ
ἄλλ	a-p---nn-	ἄλλ
ἄλλ	c--------	ἄλλ
ἀλλ’	a-p---na-	ἀλλά
ἀλλ’	c--------	ἀλλά
ἀλλ’	d--------	ἀλλά
ἀλλάξαιμ	v1saoa---	ἀλλάξαιμ
ἀλλαξαίμεθ	v1paom---	ἀλλαξαίμεθ
ἀλλάσσοντ’	v-sppama-	ἀλλάσσοντ’
ἄλλοθ	d--------	ἄλλοθ
ἄλλοσ	d--------	ἄλλοσ
ἄλλοσ	a-d---mn-	ἄλλοσ
ἄλλοτ	a-p---na-	ἄλλοτ
ἄλλοτ	d--------	ἄλλοτ
ἅλμ	n-s---na-	ἅλμ
ἁλόντ	v-sppama-	ἁλόντ
ἄλ	a-s---ma-	ἄλς
ἄλ	v3saia---	ἄλς
ἀμ	d--------	ἀμ
ἅμ	p-s---fn-	ἅμ
ἅμ	r--------	ἅμ
ἅμ	d--------	ἅμ
ἅμ	a-d---mn-	ἅμ
ἀμ	d--------	ἀμα
ἅμ	r--------	ἅμα
ἅμ	d--------	ἅμα
ἁμαρτάνουσ	v-sppafn-	ἁμαρτάνουσ
ἁμαρτοῦσ	v-sfpafn-	ἁμαρτοῦσ
ἁμαρτοῦσ	v-sapafn-	ἁμαρτοῦσ
ἄμβροτ	a-p---na-	ἄμβροτ
ἀμείβεσθ	v2ppme---	ἀμείβεσθ
ἀμείψασ	v-papafn-	ἀμείψασ
ἀμείψασ	v-sapafn-	ἀμείψασ
ἁμίλ	n-s---mn-	ἁμίλ
ἀμμείνασ	v-sapafn-	ἀμμείνασ
ἄμουσ	v-sppafn-	ἄμουσ
ἀμπάλλεσθ	v2ppie---	ἀμπάλλεσθ
ἀμπνέουσ	v-sppafn-	ἀμπνέουσ
ἀμ	d--------	ἀμτε
ἀμύνεθ	v3spie---	ἀμύνεθ
ἀμύνοντ’	v-sppama-	ἀμύνοντ’
ἀμφ	r--------	ἀμφ
ἀμφαίνουσ	v-sppafn-	ἀμφαίνουσ
ἀμφέβαλ	v3saia---	ἀμφέβαλ
ἀμφέχασκ	v3siia---	ἀμφέχασκ
ἀμφιβαλώμεθ	v1pasm---	ἀμφιβαλώμεθ
ἀμφιβάντ	v-sppama-	ἀμφιβάντ
ἀμφιβᾶσ	v-sapafn-	ἀμφιβᾶσ
ἀμφιβλήματ	n-p---na-	ἀμφιβλήματ
ἀμφότερ’	a-d---mn-	ἀμφότερ’
ἄμ	r--------	ἀνά
ἂμ	r--------	ἀνά
ἀναβᾶσ	v-sapafn-	ἀναβᾶσ
ἀνάγ	v-sapamn-	ἀνάγ
ἄναγ	d--------	ἄναγα
ἀνάγετ	v2ppma---	ἀνάγετ
ἀνάθημ	n-s---na-	ἀνάθημ
ἀνακαλούμεθ	v1pfim---	ἀνακαλούμεθ
ἀνακάλυπτ	v2spma---	ἀνακάλυπτμι
ἄνακτ	n-s---ma-	ἄνακτ
Ἄνακτ	n-s---ma-	Ἄνακτ
ἄνακτ	n-s---ma-	ἄνακτς
ἀνάξουσ	v-papafn-	ἀνάξουσ
ἀναρτήσαντ	v-sappma-	ἀναρτήσαντ
ἄνασσ	d--------	ἄνασσ
ἄνασσ	v2spma---	ἄνασσ
ἄνασσ	n-s---mv-	ἄνασσ
ἀνάσσουσ	v3ppia---	ἀνάσσουσ
ἀναστᾶσ	v-sapafn-	ἀναστᾶσ
ἀνασχέτ	v2ppma---	ἀνασχέτ
ἀνάσχοιθ	v3saom---	ἀνάσχοιθ
ἀνάσχοιτ	v3saom---	ἀνάσχοιτ
ἀνατέλλονθ	v-pppana-	ἀνατέλλονθ
ἄναυδ	a-p---na-	ἄναυδ
ἀναχορεύσατ	v2pama---	ἀναχορεύσατ
ἄνδρ’	n-s---ma-	ἄνδρ’
ἀνέβλεφ	v2paia---	ἀνέβλεφ
ἀνείλετ	v3saim---	ἀνείλετ
ἀνείλοντ	v3piie---	ἀνείλοντ
ἀνέπηλ	v3saia---	ἀνέπηλ
ἄνεργ	a-p---na-	ἄνεργ
ἀνεσκευάσμεθ	v1paim---	ἀνεσκευάσμεθ
ἀνεστείλανθ	v3paim---	ἀνεστείλανθ
ἀνέτλατ	v3saim---	ἀνέτλατ
ἀνῆκ	v3siia---	ἀνῆκ
ἀνῆλθ	v3saim---	ἀνῆλθ
ἀνήρεθ	v3siie---	ἀνήρεθ
ἀνῆψ’	v3saia---	ἀνῆψ’
ἀνθ	c--------	ἀνθ
ἀνθ	r--------	ἀνθ
Ἀνθ	r--------	Ἀνθ
Ἀνθ	c--------	Ἀνθ
ἄνθ	c--------	ἄνθ
ἁνθάδ	d--------	ἁνθάδ
ἁνίκ	d--------	ἁνίκ
ἁνίκ	d--------	ἁνίκμι
ἀνίστασ	v3ppia---	ἀνίστασ
ἄνοιγ	d--------	ἄνοιγ
ἀνοίγετ	v2ppma---	ἀνοίγετ
ἀνόνατ	v1siia---	ἀνόνατ
ἀνόνηθ’	v1slia---	ἀνόνηθ’
ἀνόνητ	a-s---ma-	ἀνόνητ
ἀντ	r--------	ἀντ
ἀνταμείψασθ’	v1pasm---	ἀνταμείψασθ’
ἄντασ	v3saia---	ἄντασ
ἀντατιμάσαιμ	v1saoa---	ἀντατιμάσαιμ
ἀντάχησ	v3saia---	ἀντάχησ
ἀντέδωκ	v1sria---	ἀντέδωκ
ἀντέδωκ	v1saia---	ἀντέδωκ
ἀντείποιμ	v1saoa---	ἀντείποιμ
ἀντέκλαγξ’	v3saia---	ἀντέκλαγξ’
ἀντέκυρσ	v1saia---	ἀντέκυρσ
ἀντελάζυτ’	v3saim---	ἀντελάζυτ’
ἀντεμηχανήσαθ	v3saim---	ἀντεμηχανήσαθ
ἀντεφθέγγετ	v3saim---	ἀντεφθέγγετ
ἀντιθεῖσ	v-sfpafn-	ἀντιθεῖσ
ἀντιλέξοντ’	v-sapama-	ἀντιλέξοντ’
ἀντιλήψεσθ’	v2pfim---	ἀντιλήψεσθ’
ἀντίπαλ	a-p---na-	ἀντίπαλ
ἀντίπηγ	n-p---na-	ἀντίπηγ
ἀντίπηγ	v2spma---	ἀντίπηγ
ἀνωφέλητ	a-p---nn-	ἀνωφέλητ
ἄνωχθ	v2srma---	ἄνωχθ
ἄξεθ	v2pfia---	ἄξεθ
ἄξετ	v2pfia---	ἄξετ
ἀξίωμ	n-p---na-	ἀξίωμ
ἀξίωμ	d--------	ἀξίωμ
ἀξίωμ	n-s---na-	ἀξίωμ
ἀξιώσατ	v2pama---	ἀξιώσατ
ἀπ	r--------	ἀπ
ἄπαγ	a-s---ma-	ἄπαγ
ἀπάγετ	v2ppma---	ἀπάγετ
Ἀπάγετ	v2ppma---	Ἀπάγετ
ἄπαιδ	d--------	ἄπαιδ
ἄπαιδ’	u--------	ἄπαιδ’
ἀπαίρωσ	v3pasa---	ἀπαίρωσ
ἅπανθ	d--------	ἅπανθ
ἅπανθ	a-s---ma-	ἅπανθ
Ἅπανθ	d--------	Ἅπανθτε
ἅπαντ	a-p---nn-	ἅπαντ
ἅπαντ	a-p---na-	ἅπαντ
ἅπαντ	a-s---ma-	ἅπαντ
ἀπάντημ	n-s---na-	ἀπάντημ
ἀπάξοντ	v-sfpama-	ἀπάξοντ
ἀπαρνούμεσθ	v1pfim---	ἀπαρνούμεσθ
ἀπέδωκ	v1saia---	ἀπέδωκ
ἄπειμ	v1spia---	ἄπειμ
ἀπείργουσ’	v3ppia---	ἀπείργουσ’
ἀπελαυνόμεθ	v1ppie---	ἀπελαυνόμεθ
Ἄπελθ	v2sama---	Ἄπελθ
ἄπελθ’	v2spma---	ἄπελθ’
ἀπέπτυσ	v3saia---	ἀπέπτυσ
ἀπέπτυσ’	v3siia---	ἀπέπτυσ’μι
ἀπέπτυσ’	v2sama---	ἀπέπτυσ’μι
ἀπέπτυσ	v2saim---	ἀπέπτυσμι
ἄπερρ’	u--------	ἄπερρ’
ἄπεστ	v3spia---	ἄπεστ
ἀπέσταλκ	v1sria---	ἀπέσταλκ
ἀπεστέρησ	v3saia---	ἀπεστέρησ
ἀπήγαγ	v3saia---	ἀπήγαγ
ἀπήγγειλ	v3siia---	ἀπήγγειλ
ἀπήλασ	v3saia---	ἀπήλασ
ἀπήμπλαχ	v3saia---	ἀπήμπλαχ
ἀπῆσθ	v2slia---	ἀπῆσθ
ἄπιστ	a-s---ma-	ἄπιστ
ἄπιστ	a-p---nn-	ἄπιστ
ἄπιστ	a-s---mv-	ἄπιστ
ἀπιστῶσ	v3ppsa---	ἀπιστῶσ
ἀφ’	r--------	ἀπό
ἀποβαλοῦσ	v-papafn-	ἀποβαλοῦσ
ἀποκουφίζουσ	v-sppafn-	ἀποκουφίζουσ
ἀπόκτειν’	v2spma---	ἀπόκτειν’
Ἀπολ	a-p---mg-	Ἀπολ
Ἀπόλ	v-sppamn-	Ἀπόλ
ἀπολάχωσ	v3pasa---	ἀπολάχωσ
ἀπολιποῦσ	v-papafn-	ἀπολιποῦσ
ἀπόλλυσ	v3spia---	ἀπόλλυσ
ἀπόλωλ	v3sria---	ἀπόλωλ
ἀπόντ	a-s---ma-	ἀπόντ
ἀποσκοποῦσ	v-sppafn-	ἀποσκοποῦσ
ἀποστᾶσ	v-sapafn-	ἀποστᾶσ
ἀποστείχοιμ	v1spoa---	ἀποστείχοιμ
ἀποστέλλουσ	v3ppia---	ἀποστέλλουσ
ἀποῦσ	v-sfpafn-	ἀποῦσ
ἄπριγδ	v1sria---	ἄπριγδ
ἀπύσατ	v3saim---	ἀπύσατ
ἀπώικισ	v3saia---	ἀπώικισ
ἀπώιχετ	v3siie---	ἀπώιχετ
ἀπῳκεῖτ’	v3siie---	ἀπῳκεῖτ’
ἀπώλεσ	v3saia---	ἀπώλεσ
ἀπώλεσ’οὐκ	v3saia---	ἀπώλεσ’οὐκ
ἀπωλέσατ	v2paia---	ἀπωλέσατ
ἀπωλόμεσθ	v1pfim---	ἀπωλόμεσθ
ἀπωλόμεσθ	v1paim---	ἀπωλόμεσθ
ἀπωλόμεσθ’	v1paim---	ἀπωλόμεσθ’
ἀπώλοντ’	v3paim---	ἀπώλοντ’
Ἀπώμοσ	v3saia---	Ἀπώμοσ
ἀπώσαιτ	v3saom---	ἀπώσαιτ
ἄρ’	g--------	ἄρ’
ἄρ’	d--------	ἄρ’
ἄραιτ	v3saom---	ἄραιτ
ἄραρ’	u--------	ἄραρ’
ἄρασσ	v2spma---	ἄρασσ
ἀργῆτ	n-s---ma-	ἀργῆτ
ἀρέσκονθ	v-pppann-	ἀρέσκονθ
ἀρέσκουσ	v3ppia---	ἀρέσκουσ
ἀρέστ	a-p---nn-	ἀρέστ
ἀρήγουσ	v-sppafn-	ἀρήγουσ
ἀρήξαντ	v-dapamn-	ἀρήξαντ
ἀρήξατ	v3saim---	ἀρήξατ
ἀρήξατ’	v2pama---	ἀρήξατ’
ἀρήξετ	v2pfia---	ἀρήξετ
ἀρθεῖσ	v-sappfn-	ἀρθεῖσ
ἀρθεῖσ	v-dappmn-	ἀρθεῖσ
ἀρθέντ	v-sappma-	ἀρθέντ
ἄριστ	a-p---nas	ἄριστ
ἄριστ	d--------	ἄριστ
ἄριστ	a-s---mv-	ἄριστ
Ἄριστ	a-s---mv-	Ἄριστ
ἀριστεύοντ	v-pppana-	ἀριστεύοντ
ἄριστ	a-p---nas	ἄριστν
ἀρκοῦνθ	v-pppann-	ἀρκοῦνθ
ἀρκύστατ	a-p---na-	ἀρκύστατ
ἅρμ	n-s---na-	ἅρμ
ἅρμ	n-s---nn-	ἅρμ
ἅρμαθ	n-p---na-	ἅρμαθ
ἅρματ	n-p---na-	ἅρματ
ἅρματ	n-p---nn-	ἅρματ
ἄρξουσ’	v3pfia---	ἄρξουσ’
ἁρπάσαντ	v-sapama-	ἁρπάσαντ
ἁρπασθεῖσ	v-sappfn-	ἁρπασθεῖσ
ἄρρητ	a-p---na-	ἄρρητ
ἄρτ	d--------	ἄρτ
ἄρχ	v2spma---	ἄρχμι
ἄρχοιτ	v3spoe---	ἄρχοιτ
ἀρχόμεσθ	v1pfim---	ἀρχόμεσθ
ἀρχόμεσθ	v1ppie---	ἀρχόμεσθ
ἄσημ	a-p---na-	ἄσημ
ἄσημ’	a-p---na-	ἄσημ’
Ἀσιάδ	n-s---fa-	Ἀσιάδ
Ἀσιάδ	g--------	Ἀσιάδ
ἀσπαίρουσ	v-sppafn-	ἀσπαίρουσ
ἀσπάσμαθ	n-p---na-	ἀσπάσμαθ
ἀσπίδ	n-s---fa-	ἀσπίδ
ἀσπούδαστ	d--------	ἀσπούδαστ
Ἀστυάνακτ	n-s---ma-	Ἀστυάνακτ
Ἀστυάνακτ	a-s---ma-	Ἀστυάνακτ
ἅτ	c--------	ἅτ
ἅτ	d--------	ἅτ
ἄτερθ	r--------	ἄτερθ
ἄτιμ	a-p---na-	ἄτιμ
ἀτιμάσασ	v-sapafn-	ἀτιμάσασ
ἀτιμάσουσ	v3pfia---	ἀτιμάσουσ
Ἄτλανθ	a-s---ma-	Ἄτλανθ
αὐτίχ	d--------	αὐθίχ
Αὐλίδ	d--------	Αὐλίδ
αὐξάνουσ	v3ppia---	αὐξάνουσ
αὐτίχ	d--------	αὐτί
αὐτίκ	d--------	αὐτίκ
αὐτίκ	d--------	αὐτίκα
αὐτίχ	d--------	αὐτίχ
αὐτόκτιτ	a-p---na-	αὐτόκτιτ
ἀφανδάνοντ	v-pppann-	ἀφανδάνοντ
ἀφείλεθ	v3saim---	ἀφείλεθ
ἀφείλετ	v3saim---	ἀφείλετ
ἀφείλετ’	v3saim---	ἀφείλετ’
ἄφελ	v2spma---	ἄφελ
ἀφέντ	v-sppama-	ἀφέντ
ἀφῆτ	v2pasa---	ἀφῆτ
ἀφιᾶσ	v3ppia---	ἀφιᾶσ
ἀφίγμεθ	v1ppie---	ἀφίγμεθ
ἀφίημ	v1spia---	ἀφίημ
ἀφίκεθ	v3saim---	ἀφίκεθ
ἀφίκεσθ	v2pamm---	ἀφίκεσθ
ἀφίκεσθ	v3saim---	ἀφίκεσθ
ἀφίκετ	v3saim---	ἀφίκετ
Ἀφίκοιτ	v3saom---	Ἀφίκοιτ
ἀφικόμεσθ	v1paim---	ἀφικόμεσθ
ἀφίκοντ	v3saim---	ἀφίκοντ
ἀφιστάμεσθ	v1pfim---	ἀφιστάμεσθ
ἀφίστασ	v3ppia---	ἀφίστασ
ἀφρονήσεθ	v2pfim---	ἀφρονήσεθ
ἄφυκτ	a-p---na-	ἄφυκτ
ἀφώρμησ	v3saia---	ἀφώρμησ
ἀχ	i--------	ἀχ
Ἀχέροντ	n-s---ma-	Ἀχέροντ
ἄχρηστ	a-p---na-	ἄχρηστ
ἅψαιτ	v3saom---	ἅψαιτ
ἁψώμεθ	v1pasm---	ἁψώμεθ
βάκ	v3saia---	βάκ
βάκ	n-p---fa-	βάκ
Βάκ	n-s---ma-	Βάκ
Βάκ	n-s---mv-	Βάκς
Βάκ	n-s---mg-	Βάκς
βακχεύητ	v2ppsa---	βακχεύητ
βακχεύοντ’	v-sppama-	βακχεύοντ’
βάκχευσ	v1saia---	βάκχευσ
βάλ	v2sama---	βάλ
βάλλουσ	v-sppafn-	βάλλουσ
βαλόντ	v-sapama-	βαλόντ
βαλοῦσ	v-sapafn-	βαλοῦσ
βάλωσ	v3pasa---	βάλωσ
βάντ	v-papana-	βάντ
βαρυάλγητ’	a-p---na-	βαρυάλγητ’
βαρυβρῶτ	a-s---ma-	βαρυβρῶτ
βαρύποτμ	a-s---mv-	βαρύποτμ
βασιλίδ	n-s---fa-	βασιλίδ
βάσταζ’	v2spma---	βάσταζ’
βαστάζουσ	v-pppafn-	βαστάζουσ
βάψασ	v-sapafn-	βάψασ
βέβακ	v3sria---	βέβακ
βέβαχ	v3sria---	βέβαχ
βέβριθ	v3sria---	βέβριθ
βιβῶντ	v-sppama-	βιβῶντ
βλάπτεσθ	v2ppme---	βλάπτεσθ
βλάστημ	n-s---nn-	βλάστημ
βλάστημ	n-s---na-	βλάστημ
βλαστοῦσ	v-sapafd-	βλαστοῦσ
βλέψασ	v-sapafn-	βλέψασ
βλέψασ	v-papafn-	βλέψασ
βλήματ	n-p---na-	βλήματ
βοσκήματ	n-p---na-	βοσκήματ
βουλεύματ	n-p---na-	βουλεύματ
βουλεύματ	n-p---nn-	βουλεύματ
βουλεύσασ	v-sapafn-	βουλεύσασ
βούσταθμ	n-s---ma-	βούσταθμ
γάσασθ	v--anm---	γάσασθ
γεγήρακ	v3sria---	γεγήρακ
γηράσκετ’	v3spie---	γηράσκετ’
γηρυθεῖσ	v-sappfn-	γηρυθεῖσ
γίγαντ	n-s---ma-	γίγαντ
γίγνοιθ	v3spoe---	γίγνοιθ
γίγνοιτ	v3spoe---	γίγνοιτ
γίγνωσκ’	v2spma---	γίγνωσκ’
γιγνώσκονθ	v-sppama-	γιγνώσκονθ
γιγνώσκοντ	v-pppann-	γιγνώσκοντ
γιγνώσκουσ	v-sppafn-	γιγνώσκουσ
γνωρίσαιμ	v1saoa---	γνωρίσαιμ
γράμματ	n-p---na-	γράμματ
γράμματ	n-p---nn-	γράμματ
γυμνάδ	a-p---na-	γυμνάδ
γυναῖκ	n-s---fa-	γυναῖκ
γυναικός’	u--------	γυναικός’
γυναῖχ	n-p---na-	γυναῖχ
γυναῖχ	n-d---fa-	γυναῖχ
Γυναῖχ	n-d---fa-	Γυναῖχ
δ’ἔκδικ	a-p---na-	δ’ἔκδικ
δάκνουσ	v3ppia---	δάκνουσ
δακρυόεντ	a-s---ma-	δακρυόεντ
δακρυόεσσ	a-p---fd-	δακρυόεσσ
δακρύτ	n-p---na-	δακρύτ
δάμαρθ	n-p---na-	δάμαρθ
δάμαρθ	n-s---fa-	δάμαρθ
δάμαρθ’	n-p---na-	δάμαρθ’
δάμαρτ	n-s---fa-	δάμαρτ
δάμαρτ’	n-s---fa-	δάμαρτ’
δαμάσασ	v-sapafn-	δαμάσασ
δαμέντ	v-sappma-	δαμέντ
δάπεδ	n-p---na-	δάπδς
δάφ	n-s---fg-	δάφ
δεδόρκατ	v1sria---	δεδόρκατ
δέδρακ	v1sria---	δέδρακ
δεδράκασ	v3pria---	δεδράκασ
δεδρακότ	v-srpama-	δεδρακότ
δεδώκασ	v3pria---	δεδώκασ
δείγματ	n-p---nn-	δείγματ
δείματ	n-p---na-	δείματ
δείματ	n-p---nn-	δείματ
δείξαθ	v3saim---	δείξαθ
δείξαθ	v2pamm---	δείξαθ
δειράδ	n-s---fa-	δειράδ
δείσασ	v-papafn-	δείσασ
δείσασ	v-sapafn-	δείσασ
Δελφίδ	n-s---fa-	Δελφίδ
Δελφίδ	n-s---ma-	Δελφίδ
δέξασθ	v2pamm---	δέξασθ
δέξατ	v3saim---	δέξατ
δεξίμηλ	a-p---na-	δεξίμηλ
δεξοίατ	v3paom---	δεξοίατ
δήσαντ	v-sapama-	δήσαντ
δι’	p-s---ma-	διά
δι’	r--------	διά
δι’	n-s---ma-	διά
Δι’	r--------	διά
διαβαλοῦσ	v-sppafn-	διαβαλοῦσ
διάγραφ	v3saia---	διάγραφ
διάδοχ	n-p---na-	διάδοχ
διαδοχαῖσ	n-p---fd-	διαδοχαῖσ
διακωλύσουσ	v-pppafn-	διακωλύσουσ
διάλλαγμ	n-s---na-	διάλλαγμ
διαλλάχθηθ	v2pamm---	διαλλάχθηθ
διαλυθεῖσ	v-sappfn-	διαλυθεῖσ
διαντλοῦσ	v-sppafn-	διαντλοῦσ
διαπεπράγμεθ’	v1prie---	διαπεπράγμεθ’
διαφθεροῦντ	v-sppama-	διαφθεροῦντ
διαφυγόνθ	v-pappna-	διαφυγόνθ
Δίδασκ’	v2spma---	Δίδασκ’μι
δίδασκ	v2spma---	δίδασκμι
δίδασχ	v2spma---	δίδασχμι
διδοῦσ	v3ppia---	διδοῦσ
διδοῦσ	v-sppafn-	διδοῦσ
διδοῦσ	v3spia---	διδοῦσ
δίδωμ	v1spia---	δίδωμ
δίδωμ’	v1spia---	δίδωμ’
διδῶσ	v3spia---	διδῶσ
δίδωσ	v3spia---	δίδωσ
δίδωσ	v3spia---	δίδωσμι
διείποιμ	v1saoa---	διείποιμ
διεμάχονθ	v3piie---	διεμάχονθ
διεπέρασ	v3saia---	διεπέρασ
διεργασθεῖτ	v3saom---	διεργασθεῖτ
διερροθήσατ	v3saim---	διερροθήσατ
διεσάφησ	v3saia---	διεσάφησ
διέφθαρκ’	v3sria---	διέφθαρκ’
διήιρηχ	v3sria---	διήιρηχ
διήλ	v3saia---	διήλ
διῆλθ	v3saia---	διῆλθ
διήμησ	v3saia---	διήμησ
διήνεγκ	v3sria---	διήνεγκ
διήνεγκ	v1saia---	διήνεγκ
Διθύραμβ	n-s---mv-	Διθύραμβ
δικαιοῦθ	v2pria---	δικαιοῦθ
δινεύουσ	v-sppafn-	δινεύουσ
διοίσουσ	v3pfia---	διοίσουσ
διοιχόμεθ	v1ppie---	διοιχόμεθ
διολέσαντ	v-papama-	διολέσαντ
διολοῦσ	v-sfpafn-	διολοῦσ
Διόνυσ	n-s---mv-	Διόνυσ
δίσσ	a-p---na-	δίσσ
δίχ	d--------	δίχ
διχοστατοῦντ	v-sppama-	διχοστατοῦντ
διωκόμεσθ	v1ppie---	διωκόμεσθ
διώκοντ	v-sppama-	διώκοντ
διώκουσ	v-sppafn-	διώκουσ
διώκουσ	v-pppafn-	διώκουσ
διώλεσ	v3saia---	διώλεσ
διώλεσ	v1saia---	διώλεσ
διώλεσ’	v1saia---	διώλεσ’
διώλετ	v3saim---	διώλετ
διώλετ’	v3saim---	διώλετ’
διώλλυθ	v3slie---	διώλλυθ
διωλόμεσθ’	v1paim---	διωλόμεσθ’
διώλοντ	v3piie---	διώλοντ
διώρισ	v3ppia---	διώρισ
δμαθέντ	v-sappma-	δμαθέντ
δόξανθ	v-pappna-	δόξανθ
δόξαντ	v-sppama-	δόξαντ
δόξαντ	v-papana-	δόξαντ
δόξασ’	v1saia---	δόξασ’
δορκάδ	n-p---na-	δορκάδ
δουρίπληχθ	a-p---na-	δουρίπληχθ
δράκοντ	n-s---ma-	δράκοντ
δράμοιμ	v1spoa---	δράμοιμ
δράσαντ	v-sapama-	δράσαντ
δράσασ	v-sapafn-	δράσασ
δράσεθ	v--fnm---	δράσεθ
δράσετ	v3sfim---	δράσετ
δράσετ’	v2pfia---	δράσετ’
δράσουσ’	v3pfia---	δράσουσ’
δράσωσ	v3pasa---	δράσωσ
δύ’	u--------	δύ’
δύναιθ	v3spoe---	δύναιθ
δυναίμεθ	v1spoe---	δυναίμεθ
δυναίμεθ	v1ppoe---	δυναίμεθ
δυναίμεθ	v3spoe---	δυναίμεθ
δύναιτ	v3spoe---	δύναιτ
δυνάμεθ	v1ppie---	δυνάμεθ
δύρεσθ	v2ppme---	δύρεσθ
δυσδαίμον’	a-s---ma-	δυσδαίμον’
δυσκόμιστ	a-p---na-	δυσκόμιστ
δύσκριτ	a-s---mv-	δύσκριτ
δύσοιστ	a-p---na-	δύσοιστ
δυσόμεσθ	v1paim---	δυσόμεσθ
δυσπήματ	n-p---na-	δυσπήματ
δύσποτμ	a-s---mv-	δύσποτμ
δυσπρόσοπτ	a-p---na-	δυσπρόσοπτ
δυσσεβέστατ	a-p---nas	δυσσεβέστατ
δύσταν’	a-s---mv-	δύσταν’
δυστόπαστ	a-p---na-	δυστόπαστ
δυστυχοῦνθ	v-sppama-	δυστυχοῦνθ
δυστυχοῦντ	v-sppama-	δυστυχοῦντ
δυστυχοῦσ	v3ppia---	δυστυχοῦσ
δυσφύλακτ	a-p---na-	δυσφύλακτ
δυσχεράναντ	v-papana-	δυσχεράναντ
δώμαθ	n-p---na-	δώμαθ
δώμαθ’	n-p---na-	δώμαθ’
δώματ	n-p---na-	δώματ
δώματ	n-p---nn-	δώματ
δώματ’	n-p---na-	δώματ’
δώματ’	n-p---nn-	δώματ’
δῶρακοὐκ	v1sria---	δῶρακοὐκ
δωρήματ	n-p---na-	δωρήματ
Δωρίδ	n-p---na-	Δωρίδ
Δωρίδ	n-s---fa-	Δωρίδ
ἔαἀλλ	c--------	ἔαἀλλ
ἔαἀλλ	v2spma---	ἔαἀλλ
ἐάσαιμ	v1saoa---	ἐάσαιμ
ἐάσατ	v2pama---	ἐάσατ
ἐάσατ	v3saim---	ἐάσατ
ἐάσετ	v3sfim---	ἐάσετ
ἐάσητ	v2pasa---	ἐάσητ
ἐατέ’	v2ppma---	ἐατέ’
ἔαφοιτωσ	v2spma---	ἔαφοιτῶσ
ἔβαλλ	v3siia---	ἔβαλλ
ἔβλαστ	v3saia---	ἔβλαστ
ἐβλαστήκασ	v3paip---	ἐβλαστήκασ
ἐγεινάμεθ	v1paim---	ἐγεινάμεθ
ἐγείνατ	v3saim---	ἐγείνατ
ἐγεύσατ	v3saim---	ἐγεύσατ
ἐγημάμεσθ	v1paim---	ἐγημάμεσθ
ἐγίγνετ	v3siie---	ἐγίγνετ
ἐγκυκλοῦντ	v-sppama-	ἐγκυκλοῦντ
ἐγνώρισ	v1saia---	ἐγνώρισ
ἐδάκρυσ	v3saia---	ἐδάκρυσ
ἐδείξατ	v3saim---	ἐδείξατ
ἐδείσατ’	v3saim---	ἐδείσατ’
ἐδέννασ	v3saia---	ἐδέννασ
ἐδέξαθ	v3saim---	ἐδέξαθ
ἐδέξαντ’	v3paim---	ἐδέξαντ’
ἐδέξατ	v3saim---	ἐδέξατ
ἐδέξατ’	v3saim---	ἐδέξατ’
ἔδρασ	v3saia---	ἔδρασ
ἔδρασ	v1saia---	ἔδρασ
Ἔδρασ	v3saia---	Ἔδρασ
ἐθαύμασ	v3saia---	ἐθαύμασ
ἐθιάσευσ	v3saia---	ἐθιάσευσ
ἐθρέψαθ	v3saim---	ἐθρέψαθ
ἐθρέψατ	v3saim---	ἐθρέψατ
ἔθρυπτ	v3siie---	ἔθρυπτ
ἔθυσ	v1saia---	ἔθυσ
εἴασ	v3saia---	εἴασ
ἴδ	v2sama---	εἶδ
Εἴθ	d--------	Εἴθ
εἴκαζ’	v2spma---	εἴκαζ’
εἱλίσσετ	v2pfia---	εἱλίσσετ
εἱλίσσοντ	v-sfpama-	εἱλίσσοντ
εἱλίσσουσ	v-sfpafn-	εἱλίσσουσ
εἵλκυσ	v3saia---	εἵλκυσ
ἴθ	v2spma---	εἶμ
ἴθ	v2ppma---	εἶμ
Εἴπ	v2sama---	Εἴπ
Εἴπ’	v2sama---	Εἴπ’
εἴπαθ	v2pama---	εἴπαθ
εἴπατ	v2pama---	εἴπατ
Εἴσ	r--------	Εἴσ
εἴσαγ	v2spma---	εἴσαγμι
εἰσακούετ’	v2ppia---	εἰσακούετ’
εἰσακούουσ’	v-pppafn-	εἰσακούουσ’
εἰσακούσασ	v-sapafn-	εἰσακούσασ
εἰσεδέξατ	v3saim---	εἰσεδέξατ
εἰσελήλυθ	v3sria---	εἰσελήλυθ
εἰσηκούσατ	v3saim---	εἰσηκούσατ
εἰσίδοιμ	v1saia---	εἰσίδοιμ
εἰσίδοιμ	v1spoa---	εἰσίδοιμ
εἰσιδοῦσ	v-sapafn-	εἰσιδοῦσ
εἴσιθ	v2ppma---	εἴσιθ
εἴσιθ’	v2ppma---	εἴσιθ’
Εἴσιτ	v2ppma---	Εἴσιτ
εἴσιθ	d--------	εἴσσιθ
ἅκ	r--------	ἐκ
ἃκ	r--------	ἐκ
κἀκ	r--------	ἐκ
Κἀκ	r--------	ἐκ
ἐκάλεσ	v3saia---	ἐκάλεσ
κἀνθάδ	d--------	ἐκἀνθάδ
ἐκαρποῦτ	v3siie---	ἐκαρποῦτ
ἕκαστ	a-p---nn-	ἕκαστ
ἔκβαλ	v3saia---	ἔκβαλ
ἐκβάλετ	v3saim---	ἐκβάλετ
ἐκβαλόντ	v-sapama-	ἐκβαλόντ
ἐκβαλοῦσ	v-papafn-	ἐκβαλοῦσ
ἐκβαλοῦσ	v-sapafn-	ἐκβαλοῦσ
ἐκβρώματ	n-p---na-	ἐκβρώματ
ἐκείρατ	v3siie---	ἐκείρατ
κἀκεῖσ	d--------	ἐκεῖσ
ἐκθηριωθεῖσ	v-sappfn-	ἐκθηριωθεῖσ
ἐκκομισθεῖσ	v-sappfn-	ἐκκομισθεῖσ
ἔκλαβ	v3siia---	ἔκλαβ
ἔκλιπ’	v2sama---	ἔκλιπ’
ἐκλιπόνθ	v-dapafn-	ἐκλιπόνθ
ἐκλιποῦσ	v-papafn-	ἐκλιποῦσ
ἐκλιποῦσ	v-sfpafn-	ἐκλιποῦσ
ἐκλιποῦσ’	v-papafn-	ἐκλιποῦσ’
ἐκλύεθ	v2pama---	ἐκλύεθ
ἐκλύσασ	v-sapafn-	ἐκλύσασ
ἐκλύσοντ	v-sfpama-	ἐκλύσοντ
ἔκμαθ	v2sama---	ἔκμαθ
Ἐκμάνθαν’	v2spma---	Ἐκμάνθαν’
ἐκνάπτετ	v3siie---	ἐκνάπτετ
ἐκοίμισ	v1saia---	ἐκοίμισ
ἐκόμισ	v3saia---	ἐκόμισ
ἐκοσμήσανθ	v3paie---	ἐκοσμήσανθ
ἔκπαγλ	a-p---nn-	ἔκπαγλ
ἔκπαγλ	a-p---na-	ἔκπαγλς
ἐκπίνουσ	v-sppafn-	ἐκπίνουσ
ἐκπλαγεῖσ	v-sappfn-	ἐκπλαγεῖσ
ἐκπλαγῆτ	v2pasa---	ἐκπλαγῆτ
ἐκπλήξασ	v-sappfn-	ἐκπλήξασ
ἐκπλήσαντ	v-sapama-	ἐκπλήσαντ
ἐκπράξασ	v-papafn-	ἐκπράξασ
ἐκπροκριθεῖσ	v-sappfn-	ἐκπροκριθεῖσ
ἐκπροτιμήσασ	v-sapafn-	ἐκπροτιμήσασ
ἐκπύθοιτ	v3saom---	ἐκπύθοιτ
ἐκρίμναθ	v3siie---	ἐκρίμναθ
ἐκρίψατ	v3saim---	ἐκρίψατ
ἐκτείνατ	v3saim---	ἐκτείνατ
ἐκτήσαθ	v3saie---	ἐκτήσαθ
ἐκτήσαθ	v3saim---	ἐκτήσαθ
ἐκτήσατ	v3saim---	ἐκτήσατ
ἐκφανεῖτ	v2pasa---	ἐκφανεῖτ
ἐκφύλασσ	v2spma---	ἐκφύλασσν
ἔλαβ	v3saia---	ἔλαβ
ἔλακ	v3spia---	ἔλακ
ἔλαχ	v3saia---	ἔλαχ
ἐλάχετ	v2paia---	ἐλάχετ
ἐλέξαθ’	v2paia---	ἐλέξαθ’
ἕλικ	d--------	ἕλικ
ἔλιπ	v3saia---	ἔλιπ
ἑλίσσετ	v3siie---	ἑλίσσετ
ἕλισσ	v2spma---	ἕλισσν
ἑλισσόμεσθ	v1pfim---	ἑλισσόμεσθ
ἑλίσσουσ	v3ppia---	ἑλίσσουσ
ἔλιφ	v3saia---	ἔλιφ
Ἑλλάδ	n-s---fa-	Ἑλλάδ
Ἑλλάδ	n-s---ma-	Ἑλλάδ
Ἑλλάδ	p-s---fa-	Ἑλλάδ
Ἑλλάδ	d--------	Ἑλλάδ
Ἑλλάδ’	n-s---fa-	Ἑλλάδ’
Ἑλληνίδ	d--------	Ἑλληνίδ
ἐλούσατ	v-sapafn-	ἐλούσατ
ἐλπίδ	n-s---fa-	ἐλπίδ
ἐλπίδ’	n-s---fa-	ἐλπίδ’
ἔλυσ	v1saia---	ἔλυσ
ἐλύσατ	v3saim---	ἐλύσατ
ἐμάθεθ	v2paia---	ἐμάθεθ
ἐμάθετ	v2pasa---	ἐμάθετ
ἐμβαλοῦσ	v-sapafn-	ἐμβαλοῦσ
ἐμείνατ	v3saim---	ἐμείνατ
ἐμήσατ	v3saim---	ἐμήσατ
Ἐμνήσατ	v3saim---	Ἐμνήσατ
ἐμπίμπρατ	a-p---na-	ἐμπίμπρατ
ἐμπλέξασ	v-sapafn-	ἐμπλέξασ
ἐνδίδωσ	v3spia---	ἐνδίδωσ
ἔνδικ	a-p---na-	ἔνδικ
ἐνδικώτατ	a-p---nns	ἐνδικώτατ
ἔνδιχ	v2spma---	ἔνδιχμι
ἔνδυθ	v2spma---	ἔνδυθ
ἐνδύτ	v3siie---	ἐνδύτ
ἔνδυτ	n-p---na-	ἔνδυτ
ἐνήλαθ	v3saim---	ἐνήλαθ
ἐνήλατ	v3saim---	ἐνήλατ
ἐνθάδ	d--------	ἐνθάδ
τἀνθάδ	d--------	ἐνθάδ
ἐνθάδ’	d--------	ἐνθάδ’
ἐνθάδ	d--------	ἐνθάδτε
ἐνθακοῦντ	v-sppama-	ἐνθακοῦντ
τἀνθένδ’	d--------	ἐνθένδ’
ἐνίοτ	d--------	ἐνίοτ
ἐννοήσασ	v-sapafn-	ἐννοήσασ
ἐνθάδ	d--------	ἐνσθάδ
ἔντιμ	a-p---na-	ἔντιμ
ἐντύναθ	v2ppme---	ἐντύναθ
ἔξαγ	v2spma---	ἔξαγμι
ἐξάγουσ	v-sppafn-	ἐξάγουσ
ἐξακρίζετ	v2ppia---	ἐξακρίζετ
ἐξαλειφθεῖσ	v-sappfn-	ἐξαλειφθεῖσ
ἐξαλείψητ’	v2pasa---	ἐξαλείψητ’
ἐξαλλάξασ	v-sapafn-	ἐξαλλάξασ
ἐξαλλάξατ	v2pama---	ἐξαλλάξατ
ἐξαμαρτάνονθ	v-sppama-	ἐξαμαρτάνονθ
ἐξαμαρτόντ	v-sapama-	ἐξαμαρτόντ
ἐξαμαρτοῦσ	v-sppafn-	ἐξαμαρτοῦσ
ἐξαμείβοντ	v-sppama-	ἐξαμείβοντ
ἐξανῆκ	v3siia---	ἐξανῆκ
ἐξανῆκ	v1saia---	ἐξανῆκ
ἐξανθοῦσ	v-sppafn-	ἐξανθοῦσ
ἐξάρασ	v3saia---	ἐξάρασ
ἔξαρχ	v2spma---	ἔξαρχμι
ἐξεβρυχᾶτ	v3plie---	ἐξεβρυχᾶτ
ἐξέθυσ	v3saia---	ἐξέθυσ
ἐξέλυσ	v3saia---	ἐξέλυσ
ἐξεπέρασ	v3saia---	ἐξεπέρασ
ἐξεπράξατ	v3saim---	ἐξεπράξατ
ἐξεπράξατ’	v3saim---	ἐξεπράξατ’
ἐξέπτατ	v3saim---	ἐξέπτατ
ἐξήγαγ	v3saia---	ἐξήγαγ
ἐξήνυσ	v3siia---	ἐξήνυσμι
ἐξηρτήσασθ	v2paim---	ἐξηρτήσασθ
ἔξιθ	v2spma---	ἔξιθ
ἐξίκοιτ	v3spoe---	ἐξίκοιτ
ἐξιόντ	v-sppama-	ἐξιόντ
ἐξιοῦσ	v-sfpafn-	ἐξιοῦσ
ἐξορμίζεσθ	v2ppme---	ἐξορμίζεσθ
ἔπαθ	v3saia---	ἔπαθ
ἐπαρκέσοντ’	v-sfpama-	ἐπαρκέσοντ’
ἐπέρασ	v3saia---	ἐπέρασ
ἐπευθύνοντ	v-sppama-	ἐπευθύνοντ
ἐπευφημήσατ	v3paie---	ἐπευφημήσατ
ἐπήγαγ	v3saia---	ἐπήγαγ
ἐπήρασθ	v2paim---	ἐπήρασθ
ἐπιβάντ	v-sapama-	ἐπιβάντ
ἐπιβᾶσ	v-sapafn-	ἐπιβᾶσ
ἔπιδ	d--------	ἔπιδ
ἐπίδρομ	v3spia---	ἐπίδρομ
ἐπιζεύξασ	v3saia---	ἐπιζεύξασ
ἐπίκλημ	n-s---na-	ἐπίκλημ
ἐπικούφιζ’	v2spma---	ἐπικούφιζ’μι
ἐπιλελήσμεθ	v1prie---	ἐπιλελήσμεθ
ἐπιοῦσ	v-sppafn-	ἐπιοῦσ
ἐπιρράξασ	v-sapafn-	ἐπιρράξασ
ἐπίσημ	n-s---na-	ἐπίσημ
ἐπισκοποῦντ	v-sppama-	ἐπισκοποῦντ
ἐπισπασθεῖσ’	v-sappfn-	ἐπισπασθεῖσ’
ἐπίστασ	v2spme---	ἐπίστασ
ἐπίστασθ	v2ppie---	ἐπίστασθ
ἐπιστέλλουσ	v3ppia---	ἐπιστέλλουσ
ἐπισφάξασ	v-sapafn-	ἐπισφάξασ
ἐπίσχετ	v2ppma---	ἐπίσχετ
ἐπίσχετ’	v2spma---	ἐπίσχετ’
ἐπλεύσατ	v3saim---	ἐπλεύσατ
ἐπολολύξατ	v3saim---	ἐπολολύξατ
ἔπρασσ	v3saia---	ἔπρασσ
ἐπράσσετ	v3siie---	ἐπράσσετ
ἔπτατ	m--------	ἔπτατ
ἐπύργωσ	v3siia---	ἐπύργωσ
ἔργματ	n-p---na-	ἔργματ
ἐρείσασ	v-papafn-	ἐρείσασ
Ἐρείσατ	v2pama---	Ἐρείσατ
ἐρείσμαθ	n-p---na-	ἐρείσμαθ
ἐρημώσασ	v-sapafn-	ἐρημώσασ
ἐρρήξαθ	v3saim---	ἐρρήξαθ
ἐρρύεθ	v3siip---	ἐρρύεθ
ἐρρύσατ	v3saim---	ἐρρύσατ
ἐλήλυθ	v1sria---	ἔρχομι
ἐσίδεσθ	v2pamm---	ἐσίδεσθ
ἐσίδοιμ	v1saia---	ἐσίδοιμ
ἐσιδόντ	v3piie---	ἐσιδόντ
ἐσιδοῦσ	v-sapafn-	ἐσιδοῦσ
ἐσπανίσμεθ	v1plie---	ἐσπανίσμεθ
ἐσπάρασσ	v3saia---	ἐσπάρασσ
ἕστακ	v3sria---	ἕστακ
ἐστάλασσ	v3siia---	ἐστάλασσ
ἑστιοῦχ	d--------	ἑστιοῦχ
ἐστράτευσ	v3saia---	ἐστράτευσ
ἐσφάλμεθ	v3siie---	ἐσφάλμεθ
ἔσχατ	a-p---na-	ἔσχατ
ἐσώικισ	v3saia---	ἐσώικισ
ἐτάμεθ	v3saim---	ἐτάμεθ
τἀνθάδ	d--------	ἐτἀνθάδ
ἐτάξαντ	v3paim---	ἐτάξαντ
ἐτεκτήναντ	v3paia---	ἐτεκτήναντ
τηλικόσδ	p-s---mn-	ἐτηλικόσδ
ἔτικτ	v3siia---	ἔτικτ
ἐτιμᾶτ	v2piia---	ἐτιμᾶτ
ἔτιχθ	v3sria---	ἔτιχθ
ἑτοίμαζ	v2spma---	ἑτοίμαζ
ἐτρεψάμεσθ	v1paim---	ἐτρεψάμεσθ
ἐτύγχαν’	v3siia---	ἐτύγχαν’
ἔτυμ	a-p---na-	ἔτυμ
τύμβευμ’	v1spia---	ἐτύμβευμ’
Εὐβοῖδ	a-s---fa-	Εὐβοῖδ
εὐλαβήθηθ’	v2samp---	εὐλαβήθηθ’
εὐνάτορ’	n-s---ma-	εὐνάτορ’
εὑρήμαθ	n-p---na-	εὑρήμαθ
εὕρισκ’	v2spma---	εὕρισκ’μι
Εὔστομ	a-p---na-	Εὔστομ
εὐτυχεῖτ	v2ppoa---	εὐτυχεῖτ
εὐτυχήματ	n-p---na-	εὐτυχήματ
εὐτύχησ	v3saia---	εὐτύχησ
εὐτύχησ’	v3daia---	εὐτύχησ’
εὐτυχοῦνθ	v-sppama-	εὐτυχοῦνθ
εὐτυχοῦντ	v-sppama-	εὐτυχοῦντ
εὐτυχοῦσ	v-pppafn-	εὐτυχοῦσ
ἔφασκ	v3siia---	ἔφασκ
ἐφάσκετ	v3siie---	ἐφάσκετ
φάσμ	v1spia---	ἐφάσμ
ἔφασχ	v3siia---	ἔφασχ
ἐφείσαθ	v3saim---	ἐφείσαθ
ἐφευρίσκεσθ	v2ppie---	ἐφευρίσκεσθ
ἐφθέγξατ	v3saim---	ἐφθέγξατ
ἔφθιθ	v3saim---	ἔφθιθ
ἐφίεθ	v3spie---	ἐφίεθ
ἐφίημ’	v1spia---	ἐφίημ’
ἐφρόντισ	v3piia---	ἐφρόντισ
ἐφύσαθ	v2paia---	ἐφύσαθ
ἐφύτευσ	v3saia---	ἐφύτευσ
ἐχράνατ	v3saim---	ἐχράνατ
ἐχρήσατ	v3saim---	ἐχρήσατ
ἔχριμπτ	v3srie---	ἔχριμπτ
ἐχρόνισ	v1siia---	ἐχρόνισ
ἐψεύσαθ	v3saim---	ἐψεύσαθ
ζεύγματ	n-p---na-	ζεύγματ
ζεύξασ	v-sapafn-	ζεύξασ
ζύγ	a-s---na-	ζύγ
ζυγέντ	v-sappma-	ζυγέντ
ἤγαγ	v3saia---	ἤγαγ
ἠγρεύσασθ	v2paim---	ἠγρεύσασθ
ἠγρίωσ	v3ppme---	ἠγρίωσ
ἠγωνίζεθ	v3siie---	ἠγωνίζεθ
ἠδικεῖτ	v3siie---	ἠδικεῖτ
ἠδίκησ	v3saia---	ἠδίκησ
ἥδιστ	a-p---na-	ἥδιστ
ἥδιστ	a-p---nn-	ἥδιστ
Ἠδωνίδ	n-s---fa-	Ἠδωνίδ
ᾐκίζεθ	v3siie---	ᾐκίζεθ
ἥκιστ	d-------s	ἥκιστ
ἥκιστ	a-p---na-	ἥκιστ
ἥκιστ’	a-p---na-	ἥκιστ’
Ἥκιστ’	a-p---na-	Ἥκιστ’
ἠκόντιζ	v3siia---	ἠκόντιζ
ἠκούσαθ	v2paia---	ἠκούσαθ
ἠκούσαθ’	v2paia---	ἠκούσαθ’
ἠκούσατ	v2paia---	ἠκούσατ
ἠκούσατ	v3saim---	ἠκούσατ
ἤλασ	v3saia---	ἤλασ
ἥλικ	v3siia---	ἥλικ
ἥλιχ	n-s---ma-	ἥλιχ
ἠλοκίσμεθ	v1paim---	ἠλοκίσμεθ
ἤλπισ	v3saia---	ἤλπισ
ἤλπισ	v1saia---	ἤλπισ
ἤλυθ	v3saia---	ἤλυθ
ἥμαρτ	v3sria---	ἥμαρτ
ἤμπλακ’	v3saia---	ἤμπλακ’
ἠνάγκασ	v3saia---	ἠνάγκασ
ἠνέγκατ	v3saim---	ἠνέγκατ
ἡνίκ	d--------	ἡνίκ
ἡνίκ	c--------	ἡνίκ
ἡνίχ	d--------	ἡνίχ
ἡνίχ	d--------	ἡνίχα
ἡνίχ	d--------	ἡνίχτε
ἤνυσ	v3saia---	ἤνυσ
ἠνύσασθ	v2paim---	ἠνύσασθ
ἠνύσατ	v3saim---	ἠνύσατ
ἠράσαθ	v3saim---	ἠράσαθ
ἤρασσ	v3siia---	ἤρασσ
ἤρξατ	v3saim---	ἤρξατ
ἥρπασ	v3saia---	ἥρπασ
ἥρπασ	v1saia---	ἥρπασ
ἥρπασ’	v3saia---	ἥρπασ’
ἠσπάζετ	v3siie---	ἠσπάζετ
ἡσυχάζεθ	v2ppma---	ἡσυχάζεθ
ἡσυχάζοντ	v-sppama-	ἡσυχάζοντ
ηὐλαβεῖθ	v3siie---	ηὐλαβεῖθ
ηὔνασ	v3saia---	ηὔνασ
ηὔξαθ	v3saim---	ηὔξαθ
ηὔξατ’	v3saim---	ηὔξατ’
ἤϋσ	v1saia---	ἤϋσ
ἥψαθ	v2paia---	ἥψαθ
ἥψατ	v3saim---	ἥψατ
θάδ	d--------	θάδ
θάκημ	n-s---nn-	θάκημ
θάλασσ	n-p---na-	θάλασσ
θάλλοντ	v-sppama-	θάλλοντ
θάλπουσ	v-pppafn-	θάλπουσ
θάμ	d--------	θάμ
θανατόεντ	a-p---nn-	θανατόεντ
θάνοιμ	v1spoa---	θάνοιμ
θάνοιμ	v1saoa---	θάνοιμ
θανόνθ	v-sapama-	θανόνθ
θανόντ	v-sapama-	θανόντ
Θανόντ	v-sapama-	Θανόντ
θανούμεθ	v1pfim---	θανούμεθ
θανούμεθ’	v1pfim---	θανούμεθ’
θανοῦσ	v-sapafn-	θανοῦσ
θάνωσ	v3pasa---	θάνωσ
θάπτ	v2spma---	θάπτ
θάπτετ	v2ppma---	θάπτετ
θαρσεῖτ	v2ppma---	θαρσεῖτ
θάσσοντ	v-sppama-	θάσσοντ
θάσσουσ	v3pfia---	θάσσουσ
θαυμάζεθ	v2ppme---	θαυμάζεθ
θαυμάσαιμ	v1saoa---	θαυμάσαιμ
θαυμάσθ	d--------	θαυμάσθν
θαυμάστ	a-p---na-	θαυμάστ
θαύματ	a-p---na-	θαύματ
θαύματ	a-p---nn-	θαύματ
θαύματ	n-p---na-	θαύματ
θάφθ	d--------	θάφθ
θάψασ	v-sapafn-	θάψασ
θάψεθ	v3sfim---	θάψεθ
θείατ	a-d---mn-	θείατ
θεοβλαβοῦνθ	v-sppama-	θεοβλαβοῦνθ
θεσπίζονθ	v-sppama-	θεσπίζονθ
θέσπισμ	n-s---na-	θέσπισμ
θέσφαθ	v2pama---	θέσφαθ
θέσφαθ	a-p---nn-	θέσφαθ
θέσφατ	a-p---na-	θέσφατ
θήξαντ	v-sapama-	θήξαντ
θήραμ	n-s---nn-	θήραμ
θηράσασ	v-sapafn-	θηράσασ
θιγγάνουσ	v-pppafn-	θιγγάνουσ
θίγοιμ	v1spoa---	θίγοιμ
θίγοιμ	v1saoa---	θίγοιμ
θιγοῦσ	v-sapafn-	θιγοῦσ
θοάζουσ	v-pppafn-	θοάζουσ
θραύματ	n-p---na-	θραύματ
θρέμματ	n-p---na-	θρέμματ
θρέψασ	v-sapafn-	θρέψασ
Θρονιάδ	n-s---fa-	Θρονιάδ
θρυλοῦσ	v-sfpafn-	θρυλοῦσ
θυγατέρ’	u--------	θυγατέρ’
θύελλ	n-p---na-	θύελλ
θύετ	v2ppma---	θύετ
θύμαθ	n-p---na-	θύμαθ
θύματ	n-p---na-	θύματ
θύματ’	n-p---nn-	θύματ’
θύοιμ	v1spoa---	θύοιμ
θύσεθ	v2pamm---	θύσεθ
τάχισθ	a-p---nas	θχύς
θώρακ	n-s---ma-	θώρακ
θωύξασ	v-sapafn-	θωύξασ
ἰαύονθ	v-sppama-	ἰαύονθ
ἵγμεθ	v1prie---	ἵγμεθ
ἰδ	c--------	ἰδ
ἴδ	v2sama---	ἴδ
Ἴδ	v2sama---	Ἴδ
Ἴδεθ	v2paia---	Ἴδεθ
ἴδεσθ	v2pamm---	ἴδεσθ
Ἴδεσθ	v2pamm---	Ἴδεσθ
ἴδετ	v2paia---	ἴδετ
ἴδητ	v2pasa---	ἴδητ
ἴδοιμ	v1saoa---	ἴδοιμ
ἰδόνθ’	v-sapama-	ἰδόνθ’
ἰδόντ	v-sapama-	ἰδόντ
ἰδούηδ	p-s---fn-	ἰδούἥδ
ἰδοῦσ	v-papafn-	ἰδοῦσ
ἰδοῦσ	v-sapafn-	ἰδοῦσ
ἰδούτοδ	p-s---nn-	ἰδούτόδ
ἱδρύεθ	v3siie---	ἱδρύεθ
ἰδώμεθ	v1pasm---	ἰδώμεθ
ἱέρακ	n-p---na-	ἱέρακ
ἵζ	v3spia---	ἵζμι
ἵζουσ’	v3ppia---	ἵζουσ’
ἵησ	v3saia---	ἵησ
ἵησ	v3spia---	ἵησ
Ἴθ	v2spma---	Ἴθ
ἴθ’	v2spma---	ἴθ’
ἴθ’	u--------	ἴθ’
ἵκεθ	v3saim---	ἵκεθ
ἵκεθ	v3sai----	ἵκεθ
ἵκετ	v3sai----	ἵκετ
ἵκετ	v3saim---	ἵκετ
ἱκετεύετ	v2ppma---	ἱκετεύετ
ἱκνεῖθ	v3spie---	ἱκνεῖθ
ἵκοιθ	v3saom---	ἵκοιθ
ἱκοίμεθ	v1paom---	ἱκοίμεθ
ἵκοιτ	v3saom---	ἵκοιτ
Ἰλιάδ	n-s---fa-	Ἰλιάδ
ἵξεσθ	v2pfim---	ἵξεσθ
ἰόντ	v-sppama-	ἰόντ
ἰοῦσ	v-pppafn-	ἰοῦσ
ἰόφ	d--------	ἰόφ
Ἱππόλυτ’	n-s---mv-	Ἱππόλυτ’
Ἱππομέδοντ	n-s---ma-	Ἱππομέδοντ
ἴσ	d--------	ἴσ
ἴσθ	v2srma---	ἴσθ
ἴσθ’	v2srma---	ἴσθ’
ἴσ	a-p---na-	ἴσν
ἴστ	v2prma---	ἴστ
ἴστ	v2pria---	ἴστ
ἵστημ	v1spia---	ἵστημ
ἱστί’	u--------	ἱστί’
ἴσχ’	v2spma---	ἴσχ’
ἴσχ’	v3spia---	ἴσχ’μι
ἴσχ	v2spma---	ἴσχμι
ἰσχνάνασ	v-sppafn-	ἰσχνάνασ
ἴσχοντ	v-sppama-	ἴσχοντ
ἴτ	v2ppma---	ἴτ
Ἴτ	v2ppma---	Ἴτ
ἴτ’	u--------	ἴτ’
Ἴτυνστένουσ	v-sppafn-	Ἴτυνστένουσ
ἴυζ	v3siia---	ἴυζ
κἀγένοντ	v-papana-	κἀγένοντ
κἄγωγ	a-p---na-	κἄγωγ
Κἄγωγ	n-p---na-	Κἄγωγ
κάθαιμ	v1spia---	κάθαιμ
καθαιματώσεθ	v2pasa---	καθαιματώσεθ
καθαιρεῖσθ	v2ppie---	καθαιρεῖσθ
καθάρμαθ	v2spma---	καθάρμαθ
κἀθαύμασ	v1saia---	κἀθαύμασ
καθάψασ	v-papafn-	καθάψασ
καθέζετ	v3siie---	καθέζετ
καθέζετ’	v3siie---	καθέζετ’
καθείρξατ	v3saim---	καθείρξατ
καθέσταθ	v2pria---	καθέσταθ
καθέστηκ	v1sria---	καθέστηκ
καθέστηχ	v3sria---	καθέστηχ
καθέστηχ	v1saia---	καθέστηχ
καθεύδουσ	v3ppia---	καθεύδουσ
καθηιμάτωσ	v3saia---	καθηιμάτωσ
καθῆκ	v1sria---	καθῆκ
καθήμεθ	v1prie---	καθήμεθ
καθήμεθ’	v1prie---	καθήμεθ’
καθῆντ	v3piie---	καθῆντ
καθήρμοσθ	v-prpenn-	καθήρμοσθ
καθῆσ	v2spme---	καθῆσ
κάθησ	v1saia---	κάθησ
καθῆσ	v2saim---	καθῆσμι
καθιεῖσ	v-pppafn-	καθιεῖσ
καθικετεύσατ	v2paia---	καθικετεύσατ
καθύβρισ	v3saia---	καθύβρισ
κάκ	a-p---na-	κάκ
κάκ	n-p---na-	κάκ
κἀκέλευσ	v3saia---	κἀκέλευσ
κακίον’	a-p---nac	κακίον’ν
κάκισθ	a-p---nas	κάκισθν
κάκιστ	a-p---nas	κάκιστ
κάκιστ	a-p---na-	κάκιστ
κάκιστ	a-s---mv-	κάκιστ
κάκιστ	d-------s	κάκιστ
κἀκκομίζεθ	v2ppme---	κἀκκομίζεθ
κακοβουληθεῖσ	v-sappfn-	κακοβουληθεῖσ
κακότατ	a-p---na-	κακότατ
κακότητ	n-s---fa-	κακότητ
καλ	n-s---ma-	καλ
καλ	a-p---na-	καλ
κάλ	a-p---na-	κάλ
καλεῖσθ	v2ppme---	καλεῖσθ
κἄλλ	a-p---na-	κἄλλ
κάλλισθ	v2srma---	κάλλισθ
κάλλισθ’	a-p---nas	κάλλισθ’
κάλλιστ	d-------s	κάλλιστ
κάλλιστ	a-p---nas	κάλλιστ
κάλλιστ	a-p---na-	κάλλιστ
καλοίμεθ	v1ppoe---	καλοίμεθ
καλοῦσ	v-sppafn-	καλοῦσ
κάλ	n-s---ma-	κάλς
κάλυμμ	n-s---na-	κάλυμμ
καλύψαθ	v2pama---	καλύψαθ
καλύψατ	v2pama---	καλύψατ
καλχαίνουσ	v-sppafn-	καλχαίνουσ
Κάλχαντ	n-s---ma-	Κάλχαντ
κἄμ	p-s---fa-	κἄμ
κἄμ	p-s---ma-	κἄμ
κἄμ’	u--------	κἄμ’
κάμνονθ	v-sppama-	κάμνονθ
κάμοιμ	v1spoa---	κάμοιμ
κἀμπνέοντ	v-sppama-	κἀμπνέοντ
κάμψαιμ	v1saoa---	κάμψαιμ
κἀνεμόεντ	v-sppama-	κἀνεμόεντ
κἀνεστήσαθ	v2paia---	κἀνεστήσαθ
κἀνήρετ	v3siie---	κἀνήρετ
κἀνθάδ	d--------	κἀνθάδ
κἀνόητ	a-p---na-	κἀνόητ
κἀνταῦθ	d--------	κἀνταῦθ
Κἀνταῦθ	d--------	Κἀνταῦθ
κἀξάγγελλ	n-p---na-	κἀξάγγελλ
κἀξέλεγχ’	v2spma---	κἀξέλεγχ’
κἀξῆλθ	v3saia---	κἀξῆλθ
κἀπ	c--------	κἀπ
κἀπ	r--------	κἀπ
κἄπειθ	d--------	κἄπειθ
κἄπειτ	c--------	κἄπειτ
κἄπειτ	d--------	κἄπειτ
Κἄπειτ	d--------	Κἄπειτ
κἀπελύσατ	v3saim---	κἀπελύσατ
κἀπιθεάζουσ	v-sppafn-	κἀπιθεάζουσ
κἀπολακτίσασ	v-sapafn-	κἀπολακτίσασ
κἀπόλωλ’	v1sria---	κἀπόλωλ’
κάρθ	n-p---na-	κάρθ
καρπίζουσ	v3ppia---	καρπίζουσ
κάρτ	d--------	κάρτ
κάρτ	n-s---na-	κάρτ
κάρτ	d--------	κάρτα
καρύξασ	v-sapafn-	καρύξασ
καρύξατ	v3saim---	καρύξατ
κασίγνηθ	n-s---mv-	κασίγνηθ
κασίγνητ	n-s---mv-	κασίγνητ
κἄστ	v3spia---	κἄστ
καθ’	r--------	κατά
κατ’	r--------	κατά
Κατ’	r--------	κατά
καταγέλωτ	v-dppamn-	καταγέλωτ
καταισχύνασ	v-sppafn-	καταισχύνασ
καταισχύνεσθ	v2ppie---	καταισχύνεσθ
κατακτενεῖτ	v3saom---	κατακτενεῖτ
κατακτήσαιτ’	v3saom---	κατακτήσαιτ’
κατάμεμπτ	v-pppann-	κατάμεμπτ
κατάρατ	a-s---mv-	κατάρατ
κατάρχεσθ	v2ppme---	κατάρχεσθ
κατασπείσουσ	v-papafn-	κατασπείσουσ
καταστένουσ	v-sppafn-	καταστένουσ
καταστέψασ	v-sapafn-	καταστέψασ
κατάστηθ	v2pama---	κατάστηθ
κατασφαγέντ	v-sappma-	κατασφαγέντ
κατάσχωσ’	v3pasa---	κατάσχωσ’
καταφθίνονθ	v-sppama-	καταφθίνονθ
κατέβαλ	v3saia---	κατέβαλ
κατέβαλλ’	v3siia---	κατέβαλλ’
κατεῖδ	v3saia---	κατεῖδ
κατείληφ	v3saia---	κατείληφ
κατεῖπ	v3siia---	κατεῖπ
κατειργάσαντ	v3paie---	κατειργάσαντ
κατεῖχ	v3siia---	κατεῖχ
κατείχεθ	v3siie---	κατείχεθ
κατείχετ	v3siie---	κατείχετ
κατέκτειν’	v3siia---	κατέκτειν’
κατέσταζ	v3siia---	κατέσταζ
κατέστησ	v3saia---	κατέστησ
κατέσχ	v3saia---	κατέσχ
κατέσχετ	v3saia---	κατέσχετ
κατέφθιθ’	v2srma---	κατέφθιθ’
κάτεχ	v3siia---	κάτεχ
κατέχετ	v2ppia---	κατέχετ
κατέχουσ	v3ppia---	κατέχουσ
κατέχουσ	v-sppafa-	κατέχουσ
κατηγγύησ	v1saia---	κατηγγύησ
κατημέλησ	v3saia---	κατημέλησ
κατθάνοιμ	v1spoa---	κατθάνοιμ
κατθανόνθ	v-sppama-	κατθανόνθ
κατθανόντ	v-sapama-	κατθανόντ
κατθανούμεθ	v1paim---	κατθανούμεθ
κατθανούμεθ	v1piie---	κατθανούμεθ
κατθανοῦσ	v-sppafa-	κατθανοῦσ
κατθανοῦσ	v-sapafn-	κατθανοῦσ
κατθανοῦσ	v-sppafn-	κατθανοῦσ
κάτισθ	v2ppia---	κάτισθ
κάτοιδ	v1sria---	κάτοιδ
κάτοιδ’	v1sria---	κάτοιδ’
κάτοισθ	v2sria---	κάτοισθ
κἀτόλμησ	v3saia---	κἀτόλμησ
κατόμνυμ	v1spie---	κατόμνυμ
κατώμοσ	v3saia---	κατώμοσ
κατώμοσ	v3diia---	κατώμοσ
κἀφ	r--------	κἀφ
κἀφίλησ	v1saia---	κἀφίλησ
κἀφυλάσσετ	v3siie---	κἀφυλάσσετ
κεκεύθασ	v3pria---	κεκεύθασ
κέλσαντ	v-sapama-	κέλσαντ
κέλσαντ	v-sfpama-	κέλσαντ
κενοταφοῦντ	v-sppama-	κενοταφοῦντ
κερκίδ	n-s---fa-	κερκίδ
κηρύγμαθ	n-p---na-	κηρύγμαθ
κήρυκ	n-s---ma-	κήρυκ
κήρυσσ	v3spia---	κήρυμσ
κηρύξαντ	v-sapama-	κηρύξαντ
κικλήσκουσ	v-sppafn-	κικλήσκουσ
κίλλουσ	v-sppafn-	κίλλουσ
κινδυνεύματ	v3siie---	κινδυνεύματ
κινοῖτ	v3spoe---	κινοῖτ
κίνυγμ	n-s---na-	κίνυγμ
κλαύμαθ	n-p---nn-	κλαύμαθ
κλέψασ	v-sapafn-	κλέψασ
κλιθεῖσ	v-sappfn-	κλιθεῖσ
κλίμακ	n-p---na-	κλίμακ
κλίνατ	v2pama---	κλίνατ
κλύεθ	v3spie---	κλύεθ
κλύετ	v2ppma---	κλύετ
κλύοιμ	v1spoa---	κλύοιμ
κλύοιτ	v2ppoa---	κλύοιτ
κλύοιτ	v3spoe---	κλύοιτ
κλύοντ	v-sppama-	κλύοντ
κλύουσ	v3ppia---	κλύουσ
κλύουσ	v-sppafn-	κλύουσ
Κλύουσ	v-sppafn-	Κλύουσ
κνώδαλ’	n-p---na-	κνώδαλ’
κοιρανοῦντ	v-sppama-	κοιρανοῦντ
κόλαζ	v2spma---	κόλαζμι
κόμιζ	v3spia---	κόμιζ
κομίζετ	v2ppma---	κομίζετ
κόμιζ	v2spma---	κόμιζμι
κομίζουσ	v-pppafn-	κομίζουσ
κομίζουσ	v3ppia---	κομίζουσ
κόμπαζ	v2spma---	κόμπαζ
κομπάσαιμ	v1saoa---	κομπάσαιμ
κομπάσαντ	v-sapama-	κομπάσαντ
κοπίδ	n-s---fa-	κοπίδ
κορεύματ	n-p---na-	κορεύματ
κόρυθ	n-s---fa-	κόρυθ
κόρυμβ	n-s---ma-	κόρυμβ
κορύσσοντ	v-sppama-	κορύσσοντ
κπέφυκ	v1sria---	κπέφυκ
κραδαίνουσ	v-sppafn-	κραδαίνουσ
κραθέντ	v-dappma-	κραθέντ
κρανθεῖσ	v-sappfn-	κρανθεῖσ
κρανθέντ’	v-pappna-	κρανθέντ’
κρατεῖσθ	v2pfim---	κρατεῖσθ
κρατηθεῖσ	v-sappfn-	κρατηθεῖσ
κρατοῦντ	v-sppama-	κρατοῦντ
κρατοῦσ	v3ppia---	κρατοῦσ
κριθέντ	v-sappma-	κριθέντ
κρίνασ	v-sapafn-	κρίνασ
κρύπτ	a-p---na-	κρύπτ
κρύπτετ	v2ppma---	κρύπτετ
κρύπτουσ	v-sppafn-	κρύπτουσ
κρύψασ	v-sapafn-	κρύψασ
κτάνοιμ	v1saoa---	κτάνοιμ
κτανόντ	v-sapama-	κτανόντ
κτανοῦσ	v-sapafn-	κτανοῦσ
κτείνασ	v-sfpafn-	κτείνασ
κτείνασ	v1saia---	κτείνασ
κτείνασ	v-sapafn-	κτείνασ
κτείνατ’	v2pama---	κτείνατ’
κτέριζ’	v2spma---	κτέριζ’μι
κτερίσματ	n-p---na-	κτερίσματ
κτήμαθ	n-p---na-	κτήμαθ
κτήματ	n-p---nn-	κτήματ
κτιζοίατ’	v3ppoe---	κτιζοίατ’
κύδιστ	a-p---na-	κύδιστ
κυκλόεντ	a-s---ma-	κυκλόεντ
κυκλοῦντ	v-sppama-	κυκλοῦντ
κύκλωμ	n-s---ma-	κύκλωμ
Κυλ	n-p---fg-	Κυλ
κυμαίνοντ	v-pppana-	κυμαίνοντ
κύματ	n-p---na-	κύματ
κύντατ	v-pppann-	κύντατ
κυρήσεθ	v3sfim---	κυρήσεθ
κυροῦνθ	v-sppama-	κυροῦνθ
κύφελλ	a-p---na-	κύφελλ
κώκυμ	n-s---nn-	κώκυμ
κωκύσουσ	v-sfpafn-	κωκύσουσ
κωκυτοῖσ	v-pppamd-	κωκυτοῖσ
κώλυμ	v1spia---	κώλυμ
κωμάζοντ	v-sppama-	κωμάζοντ
λάβ	v2sama---	λάβ
λάβεσθ	v2pamm---	λάβεσθ
λάβετ	v2pama---	λάβετ
λάβοιμ	v1saoa---	λάβοιμ
λαβοίμεθ	v1paom---	λαβοίμεθ
λαβόντ	v-dapafn-	λαβόντ
λαβοῦσ	v-sapafn-	λαβοῦσ
λαβοῦσ	v-papafn-	λαβοῦσ
λαβοῦσ’	v-sapafn-	λαβοῦσ’
λάζυσθ	v2ppme---	λάζυσθ
λάζυσθ	a-d---mn-	λάζυσθ
λάζυσθ’	v2pfim---	λάζυσθ’
λαθοῦσ	v-sapafn-	λαθοῦσ
λαθώμεθ	v1pasm---	λαθώμεθ
λακίσματ	n-p---na-	λακίσματ
λαμβάνεσθ	v2ppme---	λαμβάνεσθ
λαμβάνετ	v2ppma---	λαμβάνετ
λαμβάνουσ	v-pppafn-	λαμβάνουσ
λαμπάδ	n-s---fa-	λαμπάδ
λάμπουσ	v-sppafn-	λάμπουσ
λατρεύματ	n-p---nn-	λατρεύματ
λαχόντ	v-sapama-	λαχόντ
λαχοῦσ	v-sapafn-	λαχοῦσ
λέλακ	v3sria---	λέλακ
λέλαμ	v3prie---	λέλαμ
λελυπήμεσθ	v1prie---	λελυπήμεσθ
Λέξαθ	v2pama---	Λέξαθ
λέξανθ	v-pappna-	λέξανθ
λέξασ	v-sapafn-	λέξασ
λέξασ’	v-sapafn-	λέξασ’
λήματ	n-p---na-	λήματ
λήξασ	v-sapafn-	λήξασ
λιβάδ	n-s---fa-	λιβάδ
λίποιτ	v3saom---	λίποιτ
λιποῦσ	v-sapafn-	λιποῦσ
λιποῦσ	v3paoa---	λιποῦσ
λιποῦσ	v-papafn-	λιποῦσ
λίπωσ	v3ppsa---	λίπωσ
λοχεύμαθ	n-p---na-	λοχεύμαθ
λύεθ	v2ppma---	λύεθ
λύμαθ	n-p---na-	λύμαθ
λύματ	n-p---na-	λύματ
λύουσ	v-sppafn-	λύουσ
λύουσ	v-sfpafn-	λύουσ
λυποῖτ	v3spoe---	λυποῖτ
λυποῦσ	v3ppia---	λυποῦσ
λύπρ’	a-p---na-	λύπρ’
λύσασθ	v2pamm---	λύσασθ
μαγεύουσ	v-sppafn-	μαγεύουσ
μάθ	v2sama---	μάθ
μάθηθ	v2pama---	μάθηθ
μάθοιμ	v1saoa---	μάθοιμ
μαθόνθ	v-sapama-	μαθόνθ
μαθοῦσ	v-sapafn-	μαθοῦσ
μαινάδ	n-s---ma-	μαινάδ
μάκιστ	a-p---nas	μάκιστ
μάλ	d--------	μάλ
μάλ’	d--------	μάλ’
μαλάσσουσ	v-sppafn-	μαλάσσουσ
μαλθάκ	d--------	μαλθάκ
μαλθάσσοιμ	v1spoa---	μαλθάσσοιμ
μαλθαχθεῖσ	v-sappfn-	μαλθαχθεῖσ
μάλισθ	d--------	μάλισθ
μάλισθ	d-------s	μάλισθ
Μάλισθ’	d-------s	Μάλισθ’
μάλιστ	d-------s	μάλιστ
μάλιστ	d--------	μάλιστ
Μάλιστ	d-------s	Μάλιστ
μάλιστ’	d--------	μάλιστ’
μάλιστ’	d-------s	μάλιστ’
μανένθ	n-s---ma-	μανένθ
μανέντ’	v-sppama-	μανέντ’
μαντεύμαθ	n-p---na-	μαντεύμαθ
μαντεύμαθ’	n-p---na-	μαντεύμαθ’
μαντεύματ	n-p---na-	μαντεύματ
μαργῶντ	v-sppama-	μαργῶντ
μαρμαίροντ	v-sppama-	μαρμαίροντ
μαρτυρήσαιτ	v2paoa---	μαρτυρήσαιτ
ματεύουσ	v3ppia---	ματεύουσ
μάτευσ	v3siia---	μάτευσ
μάχοιντ	v3ppoe---	μάχοιντ
μαχούμεθ	v1pfim---	μαχούμεθ
μαχώμεθ	v1ppse---	μαχώμεθ
μεγάλ	a-p---na-	μεγάλ
μέγιστ	a-p---na-	μέγιστ
μεθίημ	v1spia---	μεθίημ
μείνασ	v-sapafn-	μείνασ
μείνατ	v2pama---	μείνατ
μελανόζυγ	a-s---fa-	μελανόζυγ
μελεδήμαθ	n-p---nn-	μελεδήμαθ
μελίκρατ	n-s---ma-	μελίκρατ
μελλόνυμ	n-s---mn-	μελλόνυμ
μερίμ	v2sria---	μερίμ
μεσάγκυλ	d--------	μεσάγκυλ
μεταβάλοιτ	v3saom---	μεταβάλοιτ
μεταβαλοῦσ	v-papafn-	μεταβαλοῦσ
μεταίχμι’	n-p---na-	μεταίχμι’
μεταλ	a-s---mn-	μεταλ
μεταλ	n-s---na-	μεταλ
μετάσταθ	v2sama---	μετάσταθ
μεταστήσουσ	v3pfia---	μεταστήσουσ
μετέβασ	v3saia---	μετέβασ
Μετρίαζ’	v3siia---	Μετρίαζ’
μηδάμ	a-p---na-	μηδάμ
Μηλιάδ	n-s---fa-	Μηλιάδ
μήματ	n-p---nn-	μήματ
μηχάνημ	n-s---nn-	μηχάνημ
μηχανήματ	n-p---na-	μηχανήματ
μιάναιμ	v1saoa---	μιάναιμ
μίασμ	n-s---na-	μίασμ
μίμημ	n-s---nn-	μίμημ
μίμημ	n-s---na-	μίμημ
μίμν’	v2spma---	μίμν’
μιμούμεθ	v1ppie---	μιμούμεθ
μισήματ	n-p---na-	μισήματ
μισούμεθ	v1ppie---	μισούμεθ
Μισοῦντ	v-sppama-	Μισοῦντ
μισοῦσ	v-pppafn-	μισοῦσ
μναστευθεῖσ	v-sappfn-	μναστευθεῖσ
μνήματ	n-p---na-	μνήματ
μονάδ	n-s---fa-	μονάδ
μονάδ	a-s---fa-	μονάδ
μόρσιμ	a-p---na-	μόρσιμ
μορφώματ	n-p---na-	μορφώματ
μοχθήματ	n-p---na-	μοχθήματ
μύζοιτ	v3spoe---	μύζοιτ
μυθεῖσθ	v1ppse---	μυθεῖσθ
μύκημ	n-s---na-	μύκημ
Μυκηνίδ	a-s---fa-	Μυκηνίδ
μυσαχθεῖσ	v-sappfn-	μυσαχθεῖσ
ναΐδ	n-s---fa-	ναΐδ
νάμαθ	n-p---na-	νάμαθ
νάματ	n-p---na-	νάματ
νάρθηκ	d--------	νάρθηκ
ναύσταθμ	n-s---ma-	ναύσταθμ
ναυστολήμαθ	a-p---na-	ναυστολήμαθ
νεβρίδ	n-s---ma-	νεβρίδ
νενίκησθ	v2prie---	νενίκησθ
νεοχάραχθ	a-p---na-	νεοχάραχθ
νθάδ	d--------	νθάδ
νικήσαντ	v-sapama-	νικήσαντ
νικῶντ	v-sppama-	νικῶντ
νικῶσ	v3ppia---	νικῶσ
νομίζετ	v2ppma---	νομίζετ
νομίζουσ	v-pppafn-	νομίζουσ
νόμιμ	a-p---na-	νόμιμ
νομισθεῖσ	v-sappfn-	νομισθεῖσ
νόμισμ	n-s---na-	νόμισμ
νόμισμ	n-s---nn-	νόμισμ
νοσήματ	n-p---nn-	νοσήματ
νοστήσασ	v-sapafn-	νοστήσασ
νύκτ	n-s---fa-	νύκτ
νυκτίφοιτ	a-p---na-	νυκτίφοιτ
νύμφευ’	v2spma---	νύμφευ’μι
νυμφεύετ	v2ppma---	νυμφεύετ
νυμφευθεῖσ	v-sappfn-	νυμφευθεῖσ
νυμφεύματ	n-p---na-	νυμφεύματ
νύχθ	n-p---na-	νύχθ
ξάνθ	a-p---na-	ξάνθ
ξασ	v1saia---	ξασ
ξήνασ	n-p---na-	ξήνασ
ξυγκάθευδ	v2spma---	ξυγκάθευδμι
ξυλλαβοῦσ	v-sapafn-	ξυλλαβοῦσ
ξυμβάντ	v-papana-	ξυμβάντ
ξύμβολ	n-p---na-	ξύμβολ
ξυμφέροντ	v-pppana-	ξυμφέροντ
ξυμφέρουσ	v3spia---	ξυμφέρουσμι
ξυναύξοινθ	v3paom---	ξυναύξοινθ
ξυνελθόντ	v-papana-	ξυνελθόντ
ξυνελθοῦσ	v-papafn-	ξυνελθοῦσ
ξυνέρξεθ	v2pfia---	ξυνέρξεθ
ξύνεστ	v3siia---	ξύνεστ
ξυνῆκ	v1saia---	ξυνῆκ
ξυνθάνοιμ	v1spoa---	ξυνθάνοιμ
ξυνθανοῦσ	v-sapafn-	ξυνθανοῦσ
ξυνθεῖσ	v-sapafn-	ξυνθεῖσ
ξύνθημ	n-s---na-	ξύνθημ
ξυνίημ	v1spia---	ξυνίημ
ξυνίημ’	v1spia---	ξυνίημ’
ξυνίσασ	v3paia---	ξυνίσασ
ξυνναίοιμ	v1spoa---	ξυνναίοιμ
ξυνόνθ	v-pppana-	ξυνόνθ
ξυστᾶσ	v-sapafn-	ξυστᾶσ
ἅδ	p-s---fn-	ὅδ
τάδ	p-p---nn-	ὅδ
τάδ	p-p---na-	ὅδ
τάδ	a-p---na-	ὅδ
τάνδ	p-s---fa-	ὅδ
τάσδ	p-p---fa-	ὅδ
τάδ’	p-p---na-	ὅδ’
τάδ’	p-p---nn-	ὅδ’
τάσδ’	p-p---fa-	ὅδ’
οἴακ’	n-s---ma-	οἴακ’
οἴαχ	n-s---fa-	οἴαχ
οἴκαδ	d--------	οἴκαδ
οἰκουρήμαθ	n-p---na-	οἰκουρήμαθ
οἰκτίρατ	v2ppma---	οἰκτίρατ
οἰκτίσαιτ	v3saom---	οἰκτίσαιτ
οἰκτρόταθ	a-s---mvs	οἰκτρόταθ
Οἴμ	v1spia---	Οἴμ
Οἴχωκ	v1sria---	Οἴχωκ
οἰωνίσματ	n-p---na-	οἰωνίσματ
ὀλέσασ	v-papafn-	ὀλέσασ
ὀλέσασ	v-sapafn-	ὀλέσασ
ὀλίγ	a-p---na-	ὀλίγ
ὄλλυσ	v3saia---	ὄλλυσ
ὁμαρτεῖτ	v2ppia---	ὁμαρτεῖτ
ὁμιλοῦντ	v-sppama-	ὁμιλοῦντ
ὄμμαθ	n-p---na-	ὄμμαθ
ὄμματ	n-p---na-	ὄμματ
Ὄμνυμ	v1spia---	Ὄμνυμ
ὁμοιώσασ	v-sapafn-	ὁμοιώσασ
ὀμόσασ	v-sapafn-	ὀμόσασ
ὀνείδιζ	v2spma---	ὀνείδιζμι
ὀνόματ	n-p---na-	ὀνόματ
ὀνόματ	n-p---nn-	ὀνόματ
ὅντιν’	p-s---ma-	ὅντιν’
ὀπαδοῦσ	v-sppafn-	ὀπαδοῦσ
ὁπηνίκ	d--------	ὁπηνίκ
ὁπλίσασ	v-sapafn-	ὁπλίσασ
ὀργίζοιτ	v3spoe---	ὀργίζοιτ
ὀρθώσατ	v2pama---	ὀρθώσατ
ὀριγνῶιτ’	v3spoe---	ὀριγνῶιτ’
ὁρμάσασ	v-sapafn-	ὁρμάσασ
ὅρπακ	n-s---ma-	ὅρπακ
ὀρφάνευμ	a-p---na-	ὀρφάνευμ
ὀρφανιεῖςἀλλ	v2spia---	ὀρφανιεῖςἀλλ
Οὐκ	d--------	οὐ
Οὐχ	d--------	οὐ
Οὔκ	d--------	Οὔ
Οὐδ	d--------	Οὐδ
οὐδάμ	a-p---nn-	οὐδάμ
Οὐδέποθ	d--------	Οὐδέποθτε
Οὐδέποτ	d--------	Οὐδέποτ
Οὐδ	c--------	Οὐδτε
Οὐδ	d--------	Οὐδτε
Οὔθ	c--------	Οὔθτε
Οὔκ	u--------	Οὔκ
Οὔτ	c--------	Οὔτ
Οὔτ	g--------	Οὔτ
Οὔτ	c--------	Οὔττε
παγ	n-s---fg-	παγ
πάγκαρπ	a-s---mv-	πάγκαρπ
πάθηθ	v--anp---	πάθηθ
πάθημ	n-s---na-	πάθημ
παθήμαθ	n-p---na-	παθήμαθ
παθοῦσ	v-papafn-	παθοῦσ
παθοῦσ	v-sapafn-	παθοῦσ
παιδεύματ	n-p---na-	παιδεύματ
παίσασ	v-sapafn-	παίσασ
Παίσασ	v-sapafn-	Παίσασ
πάλαισμ	n-s---na-	πάλαισμ
παλαίσμαθ	n-p---nn-	παλαίσμαθ
παλαίφαθ	a-p---na-	παλαίφαθ
παλίμ	n-p---na-	παλίμ
Παλλάδ	n-s---fa-	Παλλάδ
πάλλοντ	v-sppama-	πάλλοντ
παναίολ	a-p---na-	παναίολ
πανδάκρυτ	a-p---na-	πανδάκρυτ
πάνθ	a-p---na-	πάνθ
πανοῦργ	a-s---mv-	πανοῦργ
πανουργήσασ’	v-sapafn-	πανουργήσασ’
πάντ	a-p---na-	πάντ
πάντ	a-s---ma-	πάντ
πάντ	a-p---nn-	πάντ
Πάντ	a-p---na-	Πάντ
Πάντ	a-s---ma-	Πάντ
πάντολμ’	a-p---na-	πάντολμ’
παντόπτ	n-s---mv-	παντόπτ
παντόφυρτ	a-p---na-	παντόφυρτ
πανύσταθ	a-p---na-	πανύσταθ
πανύστατ	a-p---na-	πανύστατ
παρ’	r--------	παρά
Παρ’	r--------	παρά
παράδειγμ	n-s---na-	παράδειγμ
παραδίδωμ’	v1spia---	παραδίδωμ’
παραινέσαιμ	v1saoa---	παραινέσαιμ
παραινοῦσ	v-pppafn-	παραινοῦσ
παρακέλευσμ	a-s---na-	παρακέλευσμ
παρακλίνασ	v-papafn-	παρακλίνασ
παρακόμιζ	v2spma---	παρακόμιζμι
παραλαβοῦσ	v-sapafn-	παραλαβοῦσ
παραμειβόμεσθ	v1ppie---	παραμειβόμεσθ
παραμένουσ	v-pppafn-	παραμένουσ
παρασπίζοντ	v-pppana-	παρασπίζοντ
παρασπίζουσ	v-sppafn-	παρασπίζουσ
παρασπίστ	a-s---mv-	παρασπίστ
παραστᾶσ’	v-sapafn-	παραστᾶσ’
παράσχετ	v2pama---	παράσχετ
παράσχοιτ	v3saom---	παράσχοιτ
παρασχοῦσ	v-sfpafn-	παρασχοῦσ
παραυτίκ	d--------	παραυτίκ
παραυτίκ	a-p---na-	παραυτίκ
παραφέρουσ	v-pppafn-	παραφέρουσ
παρείλοντ	v-sapama-	παρείλοντ
πάρειμ	v1spia---	πάρειμ
πάρεισ	v3ppia---	πάρεισ
παρεῖσ	v-sapafn-	παρεῖσμι
παρεῖσ	v-sppafn-	παρεῖσμι
παρεῖσ	d--------	παρεῖσμι
παρεῖχ	v3siia---	παρεῖχ
παρεκ	v-papama-	παρεκ
παρέλθεθ’	v2pama---	παρέλθεθ’
παρελθόντ	v-sapama-	παρελθόντ
παρέλθωσ	v3pasa---	παρέλθωσ
πάρεργ	a-p---na-	πάρεργν
πάρεργ	d--------	πάρεργν
πάρεσθ	d--------	πάρεσθ
πάρεστ	v3spia---	πάρεστ
Πάρεστ	v3spia---	Πάρεστ
παρέστατ	v3prie---	παρέστατ
παρέστηχ	v3saia---	παρέστηχ
παρέσχ	v3saia---	παρέσχ
παρέσχ	v3siia---	παρέσχ
παρέχουσ	v-pppafn-	παρέχουσ
παρήγαγ	v3siia---	παρήγαγ
παρήγγειλ	v3siia---	παρήγγειλ
παρῆιδ	n-s---fa-	παρῆιδ
παρῆλθ	v3saia---	παρῆλθ
παρῄνεσ’	v1saia---	παρῄνεσ’
παρθέν’	u--------	παρθέν’
παρθένευμ	n-s---ma-	παρθένευμ
παρίστατ	v3spie---	παρίστατ
πάριτ	v2ppma---	πάριτ
πάριτ	v3spia---	πάριτ
πάροιθ	d--------	πάροιθ
πάροιθ	r--------	πάροιθ
παρόνθ	v-sppama-	παρόνθ
παρόντ	v-pppann-	παρόντ
παρόντ	v-pppana-	παρόντ
παρόντ	v-sppama-	παρόντ
παροῦσ	v-sppafn-	παροῦσ
παροῦσ	v-pppafn-	παροῦσ
πάροιθ	d--------	πάρσοιθ
παρώσασ	v-sapafn-	παρώσασ
πάσχετ	v3spie---	πάσχετ
πάσχουσ	v-sppafa-	πάσχουσ
πάσχουσ	v-sppafn-	πάσχουσ
πάσχουσ’	v-sppafn-	πάσχουσ’
πατέρ’	n-s---ma-	πατέρ’
πατρίδ	n-s---fa-	πατρίδ
πατρίδ’	n-s---fa-	πατρίδ’
παύσαντ	v-sapama-	παύσαντ
παύσασθ	v2pamm---	παύσασθ
Παύσασθ	v2pamm---	Παύσασθ
παχνωθεῖσ	v-pappfn-	παχνωθεῖσ
πεδήσασ	v-sapafn-	πεδήσασ
πεδί’	n-p---na-	πεδί’
πειράσατ	v2pama---	πειράσατ
πείσαντ	v-sapama-	πείσαντ
πελάσητ	v2pasa---	πελάσητ
πελασθεῖσ	v-sappfn-	πελασθεῖσ
πεμπάζετ	v2ppma---	πεμπάζετ
πέμψαθ	v2pama---	πέμψαθ
πεμψαίαθ	v3paom---	πεμψαίαθ
πέμψασ	v-sapafn-	πέμψασ
πέμψατ	v2pama---	πέμψατ
πένταθλ	a-p---na-	πένταθλ
πεπλώματ	n-p---nn-	πεπλώματ
πεπόνθασ	v3plia---	πεπόνθασ
πεπόνθατ	v2pria---	πεπόνθατ
πεπτώκατ’	v1sria---	πεπτώκατ’
πεπύσμεθ	v1prie---	πεπύσμεθ
πέργαμ	n-p---na-	πέργαμ
πέργαμ’	d--------	πέργαμ’
περίαλλ	a-p---na-	περίαλλ
περιβαλοῦσ	v-sapafn-	περιβαλοῦσ
περιπολοῦνθ	v-sppama-	περιπολοῦνθ
περιπολοῦντ	v-sppama-	περιπολοῦντ
περίπτυγμ	n-s---nn-	περίπτυγμ
περίσσ	a-p---na-	περίσσ
πέρσασ	v-papafn-	πέρσασ
πεσήματ	n-p---nn-	πεσήματ
πετάσατ	v2pama---	πετάσατ
πευκάενθ	a-s---ma-	πευκάενθ
πέφρικ	v1sria---	πέφρικ
πέφυκ	v1sria---	πέφυκ
πέφυκ	v3sria---	πέφυκ
πεφύκασ	v3pria---	πεφύκασ
πεφυκότ	v-srpama-	πεφυκότ
πέφυχ	v3sria---	πέφυχ
πέφυχ	v1sria---	πέφυχ
πήμαθ	n-p---na-	πήμαθ
πήματ	n-p---na-	πήματ
πήματ	n-p---nn-	πήματ
πήματ’	n-p---na-	πήματ’
πήματ’	n-p---nn-	πήματ’
πήξασ	v-sapafn-	πήξασ
πίθησθ	v2sasp---	πίθησθ
πίθοιμ	v1saoa---	πίθοιμ
πίμπλαθ	v3spie---	πίμπλαθ
πίμπλημ	v1spie---	πίμπλημ
πινύσκετ	v2ppma---	πινύσκετ
πιοῦσ	v-sapafd-	πιοῦσ
πίπ	v2spia---	πίπ
πίπτοντ	v-pppana-	πίπτοντ
πίπτοντ’	v-sppama-	πίπτοντ’
πίστ	a-p---na-	πίστ
πίστ	a-p---nn-	πίστ
πιστεύσαντ	v-sapama-	πιστεύσαντ
πίτ	v-sppamn-	πίτ
πίτασσ	a-p---na-	πίτασσ
πίτνοντ	v-pppann-	πίτνοντ
πλαθεῖσ	v-sappfa-	πλαθεῖσ
πλαθεῖσ	v-sappfn-	πλαθεῖσ
πλάθουσ’	v-pppafn-	πλάθουσ’
πλεύσανθ	v-sapama-	πλεύσανθ
πλεύσασ	v-papafn-	πλεύσασ
πλήγματ	n-p---nn-	πλήγματ
πληρώματ	a-p---na-	πληρώματ
πνεύματ	n-p---nn-	πνεύματ
πνεύματ	n-p---na-	πνεύματ
ποικίλ	a-p---na-	ποικίλ
ποικίλλουσ	v-sppafn-	ποικίλλουσ
ποιναθεῖσ	v-sappfn-	ποιναθεῖσ
πόλιν’	u--------	πόλιν’
πόλισμ	n-s---na-	πόλισμ
πόλισμ	n-s---nn-	πόλισμ
πολύβροχ	a-p---na-	πολύβροχ
πολύμοχθ	a-s---mv-	πολύμοχθ
πορεύσατ	v2pama---	πορεύσατ
πορθμίδ	n-s---fa-	πορθμίδ
πόρπαχ	v3saia---	πόρπαχ
πορσύνουσ	v-pppafn-	πορσύνουσ
πράγμαθ	n-p---na-	πράγμαθ
πράγμαθ	n-p---nn-	πράγμαθ
πράγματ	n-p---na-	πράγματ
πράγματ	n-p---nn-	πράγματ
πράγματ’	n-p---nn-	πράγματ’
πράξαιμ	v1saoa---	πράξαιμ
πράξαντ	v-sapama-	πράξαντ
πράξασ	v-sapafn-	πράξασ
πράσσετ	v2ppma---	πράσσετ
πράσσοιμ	v1spoa---	πράσσοιμ
πράσσονθ	v-sppama-	πράσσονθ
πράσσοντ	v-sppama-	πράσσοντ
πράσσουσ	v-sppafn-	πράσσουσ
πραχθέντ	v-pappna-	πραχθέντ
πραχθέντ’	v-pappna-	πραχθέντ’
πρεσβεύμαθ	n-p---na-	πρεσβεύμαθ
πρεσβεύματ	n-p---na-	πρεσβεύματ
πρόβαθ	v2pama---	πρόβαθ
Πρόβαθ	v2ppma---	Πρόβαθ
πρόβακχ	v2spma---	πρόβακχ
προβάλλοντ	v-sppama-	προβάλλοντ
προβλήματ	n-p---na-	προβλήματ
προθυμεῖσθ	v2ppie---	προθυμεῖσθ
πρόθυμ	a-p---na-	πρόθυμς
προθύουσ	v-sfpafn-	προθύουσ
προκαλούμεθ	v1ppie---	προκαλούμεθ
προκόψασ	v-sapafn-	προκόψασ
προλιποῦσ	v-sapafn-	προλιποῦσ
προλιποῦσ	v-papafn-	προλιποῦσ
πρόμαχ	v2spma---	πρόμαχ
προπάροιθ	d--------	προπάροιθ
προσάγετ	v2ppma---	προσάγετ
προσάξεσθ’	v1pasm---	προσάξεσθ’
προσαρμόσασ	v-sapafn-	προσαρμόσασ
προσάψασ	v-sapafn-	προσάψασ
προσβαλοῦσ	v-sapafn-	προσβαλοῦσ
προσβλέψασ	v-sapafn-	προσβλέψασ
προσδέγματ	n-p---na-	προσδέγματ
προσείπαθ	v2spma---	προσείπαθ
προσείπατ	v2ppma---	προσείπατ
προσέκυρσ	v1saia---	προσέκυρσ
προσέπτατ’	v3siie---	προσέπτατ’
προσηύξατ	v3saim---	προσηύξατ
προσθήματ	n-p---na-	προσθήματ
προσίδητ	a-d---mn-	προσίδητ
πρόσιδ	v1sria---	πρόσιδμι
προσιδοῦσ	v-sfpafn-	προσιδοῦσ
προσίζουσ	v-sppafn-	προσίζουσ
πρόσιθ	d--------	πρόσιθ
προσκύσανθ	v-dapama-	προσκύσανθ
προσπίπτουσ	v-pppann-	προσπίπτουσ
προσπίτνοντ	v-pppana-	προσπίτνοντ
προσπίτνουσ	v-sppafn-	προσπίτνουσ
προσπίτνουσ	v3ppia---	προσπίτνουσ
πρόσπτυγμ	n-s---nv-	πρόσπτυγμ
προστιθεῖσ	v-sppafn-	προστιθεῖσ
προστίθησ	v3spia---	προστίθησ
προσφθέγματ	n-p---na-	προσφθέγματ
προσφωνήμαθ	v2sama---	προσφωνήμαθ
προσώταθ	d--------	προσώταθν
προσώτατ	d--------	προσώτατ
προταρβοῦνθ	v-sppama-	προταρβοῦνθ
προτείνασ	v-papafn-	προτείνασ
προτιμῶσ	v-sppafn-	προτιμῶσ
προυκαλύψατ	v3saim---	προυκαλύψατ
προφάνηθ	v2pama---	προφάνηθ
πρύμ	n-s---fa-	πρύμ
πρώτιστ	a-p---nas	πρώτιστ
πτέρυγ	n-s---fa-	πτέρυγ
πτολίπορθ	a-s---mv-	πτολίπορθ
πτώματ	n-p---na-	πτώματ
πύθοιθ	v3saom---	πύθοιθ
Πυθώδ	v1sria---	Πυθώδ
πυλώμαθ	n-p---na-	πυλώμαθ
πυνθάνοιθ	v3spoe---	πυνθάνοιθ
πυργοῦσ	v3ppia---	πυργοῦσ
πύργωμ’	v1spia---	πύργωμ’
πύρσ	n-p---na-	πύρσ
ῥανίδ	n-s---fa-	ῥανίδ
ῥήμαθ	n-p---na-	ῥήμαθ
ῥήματ	n-p---na-	ῥήματ
ῥήματ	n-p---nn-	ῥήματ
ῥίπτετ	v2ppma---	ῥίπτετ
ῥίπτονθ	v-sppama-	ῥίπτονθ
ῥίπτουσ	v-sppafn-	ῥίπτουσ
ῥίψασ	v-papafn-	ῥίψασ
ῥίψεθ	v2pfia---	ῥίψεθ
ῥύσαιτ	v3saom---	ῥύσαιτ
ῥυσώμεθ	v1pasm---	ῥυσώμεθ
σάφ	d--------	σάφ
Σάφ	d--------	Σάφ
σαφέστατ	a-p---nas	σαφέστατ
σεβίζουσ	v-pppafn-	σεβίζουσ
σέλμαθ	n-p---na-	σέλμαθ
σημανοῦσ	v-pppafn-	σημανοῦσ
σήματ	n-p---na-	σήματ
σημήναθ	v1sria---	σημήναθ
σημήνατ’	v2pama---	σημήνατ’
σιγᾶθ	v2ppma---	σιγᾶθ
Σιγᾶτ	v2ppma---	Σιγᾶτ
σιγᾶτ’	v2ppma---	σιγᾶτ’
σιγήσαθ	v2pama---	σιγήσαθ
σιγήσατ	v2pama---	σιγήσατ
σιγήσατ’	v2pama---	σιγήσατ’
σιγῶιμ	v1spoa---	σιγῶιμ
σιγῶντ	v-sppama-	σιγῶντ
σιγῶντ’	v-sppama-	σιγῶντ’
σιγῶσ	v-sppafn-	σιγῶσ
σιωπῶσ	v3ppia---	σιωπῶσ
σκέψασθ	v2pame---	σκέψασθ
σκήψασ	v-sapafn-	σκήψασ
σκύλακ	n-s---ma-	σκύλακ
σκυλεύματ	n-p---na-	σκυλεύματ
σκυλεύματ’	n-p---na-	σκυλεύματ’
σματ	n-p---na-	σματ
σόφισμ	n-s---na-	σόφισμ
σοφίσμαθ	n-p---na-	σοφίσμαθ
σοφώταθ	a-p---nas	σοφώταθ
σπανίζουσ	v-pppafn-	σπανίζουσ
σπαραγ	n-p---na-	σπαραγ
σπαράγματ	n-p---na-	σπαράγματ
σπάσαντ	v-sapama-	σπάσαντ
σπασθεῖσ	v-sappfn-	σπασθεῖσ
σπέρματ	n-p---na-	σπέρματ
σπέρματ	n-p---nv-	σπέρματ
σπεύσαθ	v2pama---	σπεύσαθ
σπεύσασ	v-sapafn-	σπεύσασ
σπουδάσαντ	v-dapamn-	σπουδάσαντ
Σταθεῖσ	v-sappfn-	Σταθεῖσ
σταθέντ	v-sappma-	σταθέντ
σταθέντ	v-pappna-	σταθέντ
στάθητ	n-p---na-	στάθητ
στάνθ	v-sapama-	στάνθ
στάντ	v-sppama-	στάντ
στάντ	v-sapama-	στάντ
στατίζουσ	v3ppia---	στατίζουσ
στέμμαθ	n-p---na-	στέμμαθ
στέμματ	n-p---na-	στέμματ
στέμματ’	n-p---na-	στέμματ’
στέναζ	v2spma---	στέναζ
στενάζεθ	v2ppma---	στενάζεθ
στενάξασ	v-sapafn-	στενάξασ
στενάχουσ	v-sppafn-	στενάχουσ
στεφάνωμ	n-s---na-	στεφάνωμ
στήσαντ	v-dapamn-	στήσαντ
στορνύνθ	d--------	στορνύνθ
στράτευ’	v2spma---	στράτευ’
στράτευμ	v1spia---	στράτευμ
στράτευμ	n-s---na-	στράτευμ
στράτευμ	n-s---nn-	στράτευμ
στρατεύοισθ	v1ppoe---	στρατεύοισθ
στρατήγ	n-s---mv-	στρατήγ
στρατηγοῦνθ	v-sppama-	στρατηγοῦνθ
στρατηλατοῦνθ	d--------	στρατηλατοῦνθ
στρατόπεδ	n-p---na-	στρατόπεδ
στρώσασ	v-sapafn-	στρώσασ
στύγημ	n-s---na-	στύγημ
στυγοῦνθ	v-sppama-	στυγοῦνθ
στυγοῦντ	v-sppama-	στυγοῦντ
στυγοῦσ	v-sppafn-	στυγοῦσ
σύγγνωθ	v2srma---	σύγγνωθ
σύγγνωθ’	v2spma---	σύγγνωθ’
συγγνώσθ	v2ppme---	συγγνώσθ
συγγνώστ	a-p---nn-	συγγνώστ
σύγγον’	v2spma---	σύγγον’
σύγκαμ’	v2spma---	σύγκαμ’
συγχέαιμ	v1saoa---	συγχέαιμ
συγχέασ	v-sfpafn-	συγχέασ
συγχυθεῖσ	v-sappfn-	συγχυθεῖσ
συλᾶσθ	v1ppip---	συλᾶσθ
συλλάβεθ	v2pama---	συλλάβεθ
συλλαβοῦσ	v-papafn-	συλλαβοῦσ
συλλήψεσθ	v2pfim---	συλλήψεσθ
συμ	r--------	συμ
συμ	n-p---fn-	συμ
συμβαίνοντ	v-pppana-	συμβαίνοντ
συμβαίνουσ	v-pppafn-	συμβαίνουσ
συμβαλοῦσ	v-sfpafn-	συμβαλοῦσ
συμβάλωσ	v3pasa---	συμβάλωσ
σύμβολ	n-p---na-	σύμβολ
συμμοχθοῦντ	v-sfpama-	συμμοχθοῦντ
σύμπεμπ	v2spma---	σύμπεμπμι
συμπενθήσατ	v2pama---	συμπενθήσατ
συμπεσοῦσ	v-sapafn-	συμπεσοῦσ
συμπτύξασ	v-sapafn-	συμπτύξασ
σύμφημ’	a-p---nn-	σύμφημ’
συνάπτουσ	v-pppafn-	συνάπτουσ
συνάψουσ	v--fna---	συνάψουσ
σύνδεθ	v2ppma---	σύνδεθ
σύνδεσμ	n-p---nn-	σύνδεσμ
ξύνειμ	v1spia---	σύνειμ
συνείποιτ	v3saom---	συνείποιτ
συνέκυρσ	v3saia---	συνέκυρσ
συνενέγκαιμ	v1saoa---	συνενέγκαιμ
συνεξεύρισχ	v2spma---	συνεξεύρισχμι
συνεπαείδετ	v3siie---	συνεπαείδετ
συνήγαγ	v3saia---	συνήγαγ
ξυνῆκ’	v1saia---	συνῆκ’
ξυνῆχ’	v1saia---	συνῆχ’
ξυνίημ	v1spia---	συνίημ
συνίημ	v1spia---	συνίημ
ξυνίημ’	v1spia---	συνίημ’
ξύννομ	n-p---na-	σύννομ
ξύνοιδ	v1sria---	σύνοιδ
σύνοιδ	v3spia---	σύνοιδμι
συντέτηχ	v3sria---	συντέτηχ
σφαγεῖσ	v-papafn-	σφαγεῖσ
σφαγεῖσ	v-sappfn-	σφαγεῖσ
σφάζ	v3siia---	σφάζ
σφάζ	v2spma---	σφάζ
σφαλῆσθ	v1pasm---	σφαλῆσθ
σφάλματ	n-p---na-	σφάλματ
σφαχθεῖσ	v-sappfn-	σφαχθεῖσ
Σφίγγ	v3siia---	Σφίγγ
Σφίγγ	n-s---fa-	Σφίγγ
σφριγῶντ	v-sppama-	σφριγῶντ
σχήματ	n-p---na-	σχήματ
σώμαθ	n-p---na-	σώμαθ
σώμαθ	n-p---nn-	σώμαθ
σώματ	n-p---na-	σώματ
σώματ	n-p---nn-	σώματ
σώσαθ	v2pamm---	σώσαθ
σώσασ	v-sapafn-	σώσασ
τάχιστ’	a-p---nas	τ’χύς
τάχ	d--------	τά
Τάχ	d--------	Τά
τἀγάθ	p-p---na-	τἀγάθ
τἀγάθ	a-p---na-	τἀγάθ
τἀγάθ	a-p---nn-	τἀγάθ
τάδ	p-p---na-	τάδ
τάδ	p-p---nn-	τάδ
Τάδ	p-p---na-	Τάδ
Τάδ	p-p---nn-	Τάδ
τάδ’	p-p---nn-	τάδ’
τἄδικ	a-p---na-	τἄδικ
τἄδικ	a-p---nn-	τἄδικ
τἀδόκητ	n-p---na-	τἀδόκητ
ταθεῖσ’	v-papafn-	ταθεῖσ’
ταισίδ	a-p---fd-	ταισίδ
τἀκίνητ	a-p---nn-	τἀκίνητ
τάλαιν’	a-s---mv-	τάλαιν’
τάλαιν’	a-s---fv-	τάλαιν’
ταλαίπωρ’	a-s---mv-	ταλαίπωρ’
τἄλλ	a-p---na-	τἄλλ
τἄλλ	a-p---nn-	τἄλλ
τἄμ	p-p---nn-	τἄμ
τἄμ	p-p---na-	τἄμ
τἄμ	a-p---na-	τἄμ
τἄμ	a-p---nn-	τἄμ
τἄμ’	a-p---na-	τἄμ’
τἄμ’	a-p---nn-	τἄμ’
τἀμπαλάγματ	n-p---nn-	τἀμπαλάγματ
τἀμπλάκημ	n-s---na-	τἀμπλάκημ
τἀμπλακήμαθ	n-p---na-	τἀμπλακήμαθ
τἀνάλωμ	a-p---na-	τἀνάλωμ
τάνδ	p-s---fa-	τάνδ
Τάνδ	p-s---fa-	Τάνδ
τἄνδιχ	d--------	τἄνδιχ
τἀνθάδ	d--------	τἀνθάδ
τἀνθάδ’	d--------	τἀνθάδ’
τἀνθάδ	d--------	τἀνθάδτε
Τἀνθάδ	d--------	Τἀνθάδτε
τἀνθένδ	d--------	τἀνθένδ
τἀξίωμ	n-s---nn-	τἀξίωμ
τἀπ	r--------	τἀπ
τἀπ	p-p---na-	τἀπ
τἀπίλοιπ	n-p---na-	τἀπίλοιπ
ταρβεῖτ	v2ppma---	ταρβεῖτ
ταρβήσασ	v-sapafn-	ταρβήσασ
τἄργ	n-p---nn-	τἄργ
τἀρκοῦντ	v-sppama-	τἀρκοῦντ
τἄρρηθ	p-p---na-	τἄρρηθ
τἄρρητ	a-p---na-	τἄρρητ
τἀφ	r--------	τἀφ
τάχ	d--------	τάχ
Τάχ	d--------	Τάχ
τάχ’	d--------	τάχ’
τάχ	d--------	τάχα
Τάχ	d--------	Τάχα
ταχύνασ’	v-papafn-	ταχύνασ’
τεθάμβηκ’	v1sria---	τεθάμβηκ’
τεθράμμεθ	v1prie---	τεθράμμεθ
τείσασθ	v2pamm---	τείσασθ
τελευτήσαντ	v-sapama-	τελευτήσαντ
τέρματ	n-p---nn-	τέρματ
τέρματ	n-p---na-	τέρματ
τέταχθ	v3srie---	τέταχθ
Τευκρίδ	n-s---ma-	Τευκρίδ
τεχνάσματ	n-p---nn-	τεχνάσματ
τεχνήματ	n-p---na-	τεχνήματ
τηλικάσδ	a-p---fa-	τηλικάσδ
τηλικόσδ	a-p---ma-	τηλικόσδ
τηνίκ	d--------	τηνίκ
τηνικαῦθ	d--------	τηνικαῦθτε
τηνικαῦτ	d--------	τηνικαῦτ
τιθεῖσ	v3spia---	τιθεῖσ
τιθεῖσ	v-sfpafn-	τιθεῖσ
τιθεῖσ	v-sapafn-	τιθεῖσ
τιθεῖσ	v-sppafn-	τιθεῖσ
τιθέμεσθ	v1ppie---	τιθέμεσθ
τιθέντ	n-s---ma-	τιθέντ
τίθημ	v1spia---	τίθημ
τίκτουσ	v-sppafn-	τίκτουσ
τίκτουσ	v-pppafn-	τίκτουσ
τίλλονθ’	v-sppama-	τίλλονθ’
τιμῶσ	v-sppafn-	τιμῶσ
τιν’	p-s---ma-	τιν’
τιν’	p-s---fa-	τιν’
τίν’	p-s---ma-	τίν’
τίνοιμ	v1spoa---	τίνοιμ
τίπτ	d--------	τίπττε
τίχ	d--------	τίχ
τοιάδ	a-p---na-	τοιάδ
τοιάδ	p-p---na-	τοιάδ
τοιάδ	p-p---nn-	τοιάδ
τοιάδ	a-p---nn-	τοιάδ
τοιάδ	p-s---fa-	τοιάδ
τοιάδ	p-s---fn-	τοιάδ
τοιάδ’	p-p---na-	τοιάδ’
τοιάδ’	a-p---na-	τοιάδ’
τοιάνδ	p-s---fa-	τοιάνδ
Τοιάνδ	p-s---fa-	Τοιάνδ
τοιάσδ	p-p---fa-	τοιάσδ
Τοιάσδ	p-p---fa-	Τοιάσδ
τοιάσδ’	p-p---fa-	τοιάσδ’
τοιάσδ’	a-p---fa-	τοιάσδ’
τοισίδ	p-p---nd-	τοισίδ
τοισίδ	p-s---na-	τοισίδ
τοισίδ	p-p---md-	τοισίδ
τολμήμαθ	a-p---nac	τολμήμαθ
τολμήσατ	v3saim---	τολμήσατ
τοσάσδ	a-p---fa-	τοσάσδ
τοὐπίκλημ	n-s---na-	τοὐπίκλημ
τοὐπίσημ	n-s---na-	τοὐπίσημ
τράπεζ	n-s---fa-	τράπεζ
τράποιτ	v3saom---	τράποιτ
τραπώμεθ	v1pasm---	τραπώμεθ
τραύμαθ	n-p---na-	τραύμαθ
τραύματ	n-p---na-	τραύματ
τραφέντ	v-sappma-	τραφέντ
τράχυν’	a-s---ma-	τράχυν’
τρίποδ	n-s---ma-	τρίποδ
τρίποδ’	u--------	τρίποδ’
τρίτ	a-p---nn-	τρίτ
τροχηλατήσουσ	v3pfia---	τροχηλατήσουσ
Τρωιάδ	a-s---fa-	Τρωιάδ
Τρωιάδ	n-s---ma-	Τρωιάδ
τυγχάνουσ	v-sppafn-	τυγχάνουσ
Τυνδαρίδ	n-s---ma-	Τυνδαρίδ
τυραννίδ	n-s---fa-	τυραννίδ
τύχοιμ	v1spoa---	τύχοιμ
τύχοιμ	v1saoa---	τύχοιμ
τυχόντ	v-pppann-	τυχόντ
τυχόντ	v-sfpama-	τυχόντ
τυχοῦσ	v-sapafn-	τυχοῦσ
τυχοῦσ	v-papafn-	τυχοῦσ
τάχιστ	a-p---nas	τχύς
ὕβριζ	v3siia---	ὕβριζ
ὕβριζ’	v1siia---	ὕβριζ’μι
ὑβρίζουσ	v-sppafn-	ὑβρίζουσ
ὑβρίζουσ	v3ppia---	ὑβρίζουσ
ὑβρίζουσ’	v3ppia---	ὑβρίζουσ’
ὕβρισ	v3saia---	ὕβρισ
ὕβρισμ	n-s---na-	ὕβρισμ
ὑγράνασ	v-sapafn-	ὑγράνασ
ὑγρότητ	n-p---na-	ὑγρότητ
ὕμ	v3saia---	ὕμ
ὔμμ	p-p----d-	ὔμμ
ὑμνοῖθ	v3spoe---	ὑμνοῖθ
ὑμνοῦσ	v3ppia---	ὑμνοῦσ
ὑπ	r--------	ὑπ
ὑπ	v2spia---	ὑπ
ὕπ	r--------	ὕπ
ὕπ’	u--------	ὕπ’
ὑπεκβᾶσ	v-sapafn-	ὑπεκβᾶσ
ὑπεξῆλθ	v3saia---	ὑπεξῆλθ
ὑπέρβαλλ	v2spma---	ὑπέρβαλλ
ὑπερβάλλοντ	v-pppana-	ὑπερβάλλοντ
ὑπερβαλόνθ	v-sapama-	ὑπερβαλόνθ
ὑπέρδικ	d--------	ὑπέρδικ
ὕπερθ	r--------	ὕπερθ
ὑπερθέοντ	v-sppama-	ὑπερθέοντ
ὑπερθρώισκονθ	v-sppema-	ὑπερθρώισκονθ
ὑπερπαθήσασ	v-sapafn-	ὑπερπαθήσασ
ὑπερτέλλοντ	v-sppama-	ὑπερτέλλοντ
ὑπερτέλλουσ	v3spia---	ὑπερτέλλουσ
ὑπέστητ	v3saim---	ὑπέστητ
ὑπέσχεθ	v3saim---	ὑπέσχεθ
ὑπέσχετ	v3siie---	ὑπέσχετ
ὑπέσχετ	v3saim---	ὑπέσχετ
ὑπῆρχ	v3siia---	ὑπῆρχ
ὑπ’	r--------	ὑπό
ὑφ’	r--------	ὑπό
ὑποβλεπώμεθ	v1ppie---	ὑποβλεπώμεθ
ὑπολάβοιμ	v1saoa---	ὑπολάβοιμ
Ὑφ	r--------	Ὑφ
ὕφ	r--------	ὕφ
ὑφάσμαθ	n-p---na-	ὑφάσμαθ
ὑφεῖσ	v3spia---	ὑφεῖσμι
ὑφήνασ	v1saia---	ὑφήνασ
ὕφιζ’	v2spma---	ὕφιζ’μι
ὑψήλ	n-p---na-	ὑψήλ
ὕψιστ	d--------	ὕψιστ
φαέθοντ	v-pppana-	φαέθοντ
φάμ	v1spia---	φάμ
φανεῖσ	v1saop---	φανεῖσ
φανεῖσ	v-sappfn-	φανεῖσ
φανέντ	v-pappna-	φανέντ
φανέντ	v-sappma-	φανέντ
φάνηθ	v2samp---	φάνηθ
φανούμεθ	v1pfim---	φανούμεθ
φανούμεθ’	v1pfim---	φανούμεθ’
φάντασμ	r--------	φάντασμ
φάντασμ	d--------	φάντασμ
φανῶσ	v3pasp---	φανῶσ
φάραγγ	n-p---na-	φάραγγ
φάρμακ	n-p---na-	φάρμακ
φάρμαχ	n-p---na-	φάρμαχ
φασ	v3ppia---	φασ
φάσ	v3ppia---	φάσ
φάσκοιμ	v1spoa---	φάσκοιμ
φάσμ	n-s---na-	φάσμ
φάσματ	n-p---na-	φάσματ
φάτ	n-p---fn-	φάτ
φατίσαιμ	v1saoa---	φατίσαιμ
φατισθεῖσ’	v-sappfn-	φατισθεῖσ’
Φερσέφασσ	n-p---nn-	Φερσέφασσ
φευξοίαθ	v3ppoe---	φευξοίαθ
φθάνοιτ	v3paom---	φθάνοιτ
φθέγμαθ	n-p---na-	φθέγμαθ
φθέγματ	n-p---na-	φθέγματ
φθέγματ’	n-p---nn-	φθέγματ’
Φθιάδ	n-s---fa-	Φθιάδ
φθίνοντ	v-pppana-	φθίνοντ
φθίνουσ	v3ppia---	φθίνουσ
φίλ	a-s---mv-	φίλ
φίλ	a-p---na-	φίλ
φιληθεῖσ	v-sappfn-	φιληθεῖσ
φίλημ	n-s---na-	φίλημ
φιλήματ	n-p---na-	φιλήματ
Φιλοκτῆτ	n-s---ma-	Φιλοκτῆτ
φιλότητ	n-s---fa-	φιλότητ
φιλοῦσ	v-sppafn-	φιλοῦσ
φίλ	a-s---mv-	φίλς
φίλταθ	a-s---mv-	φίλταθ
φίλταθ	a-p---na-	φίλταθ
φίλτατ	a-p---na-	φίλτατ
φίλτατ	a-p---nn-	φίλτατ
φίλτατ	a-s---fv-	φίλτατ
φίλτατ	a-s---mv-	φίλτατ
φίλτατ’	a-s---mv-	φίλτατ’
φοίνικ	n-s---ma-	φοίνικ
φοίνισσ	n-s---md-	φοίνισσ
φονεύσατ	v3saim---	φονεύσατ
φράζ	v2spma---	φράζ
φράζετ	v2ppma---	φράζετ
φράζ	v2spma---	φράζμι
φράζουσ	v3ppia---	φράζουσ
φράσαιμ	v1saoa---	φράσαιμ
φράσουσ	v3pfia---	φράσουσ
φρονήματ	n-p---na-	φρονήματ
φρονήσατ	v2pama---	φρονήσατ
φροντίδ	n-s---fa-	φροντίδ
φρόντιζ	v2spme---	φρόντιζ
φρόντιζ’	v2spma---	φρόντιζ’μι
φροντίζεθ	v2ppma---	φροντίζεθ
φρυάγμαθ	n-p---na-	φρυάγμαθ
φυγάδ	d--------	φυγάδ
φύγοιμ	v1saoa---	φύγοιμ
φύλακ	n-s---ma-	φύλακ
φύλασσ	v2spma---	φύλασσ
φυλάσσεθ	v2ppme---	φυλάσσεθ
φυλάσσεσθ	v2ppme---	φυλάσσεσθ
φυλάσσετ	v2ppma---	φυλάσσετ
φύλασσ	v2spma---	φύλασσμι
φυλάσσουσ	v-pppafn-	φυλάσσουσ
φύλλ	n-p---na-	φύλλ
φύσαντ	v-sapama-	φύσαντ
φύσημ	n-s---na-	φύσημ
φυσῶντ	v-sppama-	φυσῶντ
φύτευμ	n-s---na-	φύτευμ
φωνήσατ	v2pama---	φωνήσατ
Φωνήσατ	v3saim---	Φωνήσατ
χάλαζ	v3spia---	χάλαζ
χαλκήλαθ	v-pappna-	χαλκήλαθ
χαρακτῆρ’	n-s---ma-	χαρακτῆρ’
χάρματ	n-p---na-	χάρματ
χερμάδ	n-s---fa-	χερμάδ
χέρνιβ	a-p---nn-	χέρνιβ
χέρνιβ	n-p---na-	χέρνιβ
χήματ	n-p---na-	χήματ
χοράγ	n-s---ma-	χοράγ
χορεύματ	n-p---nn-	χορεύματ
ΧΟΡΟΣμηδάμ	v1sria---	ΧΟΡΟΣμηδάμτε
χρανθεῖσ	v-sappfn-	χρανθεῖσ
χρήμαθ	n-p---na-	χρήμαθ
χρήματ	n-p---na-	χρήματ
χρήματ	n-p---nn-	χρήματ
χρήσαντ	v-sapama-	χρήσαντ
χρίσασ	v-sapafn-	χρίσασ
χρισθεῖσ	v-sappfn-	χρισθεῖσ
χρυσοκέρατ	a-s---ma-	χρυσοκέρατ
χρύσωμ	n-p---na-	χρύσωμ
χὐπερορρωδοῦσ	v-sppafn-	χὐπερορρωδοῦσ
χωρισθεῖσ	v-sappfg-	χωρισθεῖσ
ψάλλ	v2spma---	ψάλλμι
ὠδίνουσ	v-sppafn-	ὠδίνουσ
ὤικισ	v3saia---	ὤικισ
ὤικτισ’	v3saia---	ὤικτισ’
ᾠκτίρεθ	v3siie---	ᾠκτίρεθ
ὠκύτητ	n-p---na-	ὠκύτητ
ὠλβίζετ	v3siie---	ὠλβίζετ
ὤλβισ	v3saia---	ὤλβισ
ὠλέσατ’	v2pama---	ὠλέσατ’
ὤλλυθ	v3siie---	ὤλλυθ
ὠνείδισ	v3saia---	ὠνείδισ
ὠρέξατ	v3saim---	ὠρέξατ
