τἀναντί	d--------	τἀναντίτε
βία	n-s---fn-	βία	βῐ́ᾱ
προύργου	n-s---mg-	προύργης
ἀγύρτρια	a-s---fn-	ἀγύρτριος	ἀγῠρτρια
διάσημα	a-p---nn-	διάσημος
ἐρημία	n-s---fn-	ἐρημία
ἀπόλωλε	v3sria---	ἀπόλλυμι
στραφεὶς	v-sappmn-	στρέφω
ὑψιγέννητον	a-s---ma-	ὑψιγέννητος
λατρεύματα	n-p---na-	λατρεύματα
εὑρεθέντα	v-sappma-	εὑρίσκω
ἀρωγάν	n-s---na-	ἀρωγάν
λήθη	n-s---fn-	λήθη
ῥιπτεῖ	v3spia---	ῥίπτω
κλυτοῖς	a-p---nd-	κλυτός
ἀφίκετο	v3saim---	ἀφικνέομαι
μοχθεῖν	v--pna---	μοχθέω
ὑπερβαλώμεθα	v1pasm---	ὑπερβάλλω
βόα	V-	βόος
ἐκβάληι	v2sasm---	ἐκβάληι
ἐμοί;	p-s---md-	ἐμοί;
πλεύσωμεν;	v1pasa---	πλεύσωμεν;
ναυτικὸν	a-s---ma-	ναυτικός
Λάιός	n-s---mn-	Λάιός
λευστήρων	v-sppamn-	λευστήρω
στρατηγὸν	Nb	στρατηγός
ἔξαγ	v2spma---	ἔξαγμι
καλλονῆς;	n-s---fg-	καλλονῆς;
θάρσος	n-s---nn-	θάρσος
ὀλούμεθα;	v1ppse---	ὀλούμεθα;
ἥιμαξαν	v3paia---	ἥιμαξαν
ἁλόντ	v-sppama-	ἁλόντ
Νηρήιδων	n-p---mg-	Νηρήιδες
ἐρωτήσω	v1sfia---	ἐρωτάω
οὖσα	v-sppafn-	εἰμί
ἔσταζ	V-	ἔσταζ
κἀπιχωρίοις	a-p---md-	κἀπιχωρίοις
μη	d--------	μή
προσῆκες·	v2siia---	προσῆκες·
διαμεθῆις	v2saoa---	διαμεθῆις
προδότιν	n-s---fa-	προδότις
ῥώμη	n-s---fn-	ῥώμη
ἐξέφυσε	v3saia---	ἐξοφύω
λήξει	v3sfia---	λήχω
ἐπίφθονος	a-s---mg-	ἐπίφθων
ἐναργὴς	a-s---mn-	ἐναργής
σέβοι	v3spoa---	σέβω
ῥαιθυμίαν	n-s---fa-	ῥαιθυμία
κλεινὸν	a-s---nn-	κλεινός
δειλαία·	a-s---fv-	δειλαία·
περιβαλὼν	v-sapamn-	περιβάλλω
ἰαχᾶς	n-p---fa-	ἰαχᾶς
πυργοῦν	n-s---ma-	πυργοῦς
φθιτοῖς	n-p---md-	φθιτός
σίνος·	n-s---mn-	σίνος·
χρῄζειν	v--pna---	χρῄζω
ἄσκοπα	a-p---nn-	ἄσκοπος
πορθμεύουσ	v-pppafn-	πορθμεύουσ
ὤφελόν	v1saia---	ὤφελόν
γυναῖκες;	u--------	γυναῖκες;
λήματος	n-s---ng-	λῆμα
ἀκραιφνεῖς	a-p---ma-	ἀκραιφνής
ὁρίζηι	v3spoa---	ὁρίζηι
ὄσσοις	a-p---nd-	ὄσσε
γοᾶσθ	V-	γοᾶσθ
νῆες	n-p---fn-	ναῦς
ἔφυ·	v3saia---	ἔφυ·
μορ	n-p---md-	μορ
νετ	v3siie---	νετ
συγκοιμωμένη	v-srpefn-	συγκοιμωμένη
ἰσχύεις	v2spia---	ἰσχύω
κακὴ	a-s---fa-	κακός
κομπὸς	n-s---mn-	κομπὸς
φρονοῦμεν	v1ppia---	φρονέω
ἕν	r--------	εἷς
ἐπέβαλε	v3saia---	ἐπιβάλλω
ἀμαυρᾶς	n-s---fg-	ἀμαυρᾶς
φορβάν	n-s---fa-	φορβάν
ἀμφιθαλὴς	a-s---mn-	ἀμφιθαλής
τυραννικοῖς	a-p---md-	τυραννικός
ἵμερος·	n-s---mn-	ἵμερος·
ἐξαιτῇ	V-	ἐξαιῇ
κατήινεσας	v2saia---	κατήινεω
ἰαχὰν	n-s---fa-	ἰαχὰ
εἰσιδοῦσα	v-sapafn-	εἰσιδίδωμι
πείθωμεν	v1ppsa---	πείθω
γραμμῆς	n-s---fg-	γραμμή
σκαιὸν	a-s---na-	σκαιός
πέδονδε	d--------	πέδονδε
κλῆιδας	n-p---fa-	κλῆις
κνεφαῖά	n-p---na-	κνεφαῖος
εὐτύχει	v3spia---	εὐτύχει
’	R-	ό
σοῦ	p-s---fg-	σύ
ἐννόμοις	a-p---nd-	ἐννόμος
κύνες·	n-p---fn-	κύνες·
