α	Pr	α
ἄ	x--------	ἄ
ἁβροκόμαν	Ne	ἁβροκόμας
ἀγαθῶν	A-	ἀγαθός
ἄγαλμ	V-	ἄγαλμ
ἀγαλμάτων	Nb	ἀγαλμάτων
ἄγαμος	A-	ἄγαμος
ἄγαν	Df	ἄγαν
ἀγῶν	V-	ἀγάω
ἄγγελλε	V-	ἀγγέλλω
ἄγγελον	Nb	ἄγγελον
ἀγγέλου	Nb	ἄγγελος
ἀγγέλῳ	Nb	ἄγγελος
ἄγειν	V-	ἄγειν
ἄγετ	Df	ἄγετ
ἄγετε	V-	ἄγετε
ἁγηλατήσειν	V-	ἁγηλατήσειν
ἁγνιῶ	V-	ἁγνιῶ
ἀγρευτᾶι	Nb	ἀγρευτᾶι
ἀγρίᾳ	A-	ἀγρῖος
ἀγρίων	A-	ἄγριος
ἀγύρτην	Nb	ἀγύρτης
ἀγωνίων	A-	ἀγώνιος
ἅδ	V-	ἅδ
ἀδελφῆι	Nb	ἀδελφῆ
ἀδελφὸς	Nb	ἀδελφός
Ἅιδα	n-s---mg-	ᾅδης
Ἀΐδαν	n-s---ma-	ᾅδης
Ἅιδῃ	n-s---md-	ᾅδης
Ἅιδην	n-s---ma-	ᾅδης
Ἅιδης	n-s---fg-	ᾅδης
Ἅιδης	n-s---mn-	ᾅδης
Ἄιδος	n-s---mg-	ᾅδης
Ἅιδου	n-s---mg-	ᾅδης
ἀδικεῖτ’	V-	ἀδικεῖτ’
ἀδικεῖ	V-	ἀδικέω
ἀδικεῖν	V-	ἀδικέω
ἀδικήσαντά	V-	ἀδικήσαντά
ἄδικα	A-	ἄδικος
ἄδικος	A-	ἄδικος
ἀδίκων	A-	ἄδικος
ἀδικῶ	V-	ἀδικῶ
ἀδίκωι	A-	ἀδίκωι
Ἀδμήτωι	Ne	Ἀδμήτωι
Ἄδραστος	Ne	Ἄδραστος
ἀδύναθ	V-	ἀδύναθ
ἀδύνατ	V-	ἀδύνατ
ἀδύνατά	A-	ἀδύνατος
ἀει	V-	ἀει
ἀεὶ	Df	ἀεί
ἀείμνηστον	A-	ἀείμνηστος
ἄρας	Nb	ἀείρω
ἀήθης	A-	ἀήθης
Ἀθηνῶν	Ne	ἀθῆναι
ἄθλι	A-	ἄθλι
ἀθλίαν	A-	ἀθλίαν
ἀθλία	A-	ἀθλίος
ἄθλιος	A-	ἄθλιος
ἄθλων	n-p---ng-	ἆθλον
ἄθλοισι	n-p---md-	ἆθλος
ἄθλους	n-p---ma-	ἆθλος
ἄθλου	Nb	ἄθλου
ἀθροίσας	V-	ἀθροίζω
ἀθροῖσαι	V-	ἀθροῖζω
αἰανῆ	Ne	αἰανῆ
Αἴανθ	V-	Αἴανθ
αἴας	Ne	αἴας
Αἰγύπτου	Ne	αἴγυπτος
Αἰγύπτωι	Nb	Αἰγύπτω
Ἅιδαν	Ne	Ἅιδαν
Ἀίδας	Ne	Ἀίδης
αἰδοίων	A-	αἰδοῖος
αἰδούμεθ	V-	αἰδούμεθ
αἰθερία	A-	αἰθερίος
αἱμοσταγὲς	Nb	αἱμοσταγής
αἴνιγμ	Nb	αἴνιγμ
αἰσχρὰ	A-	αἰσχρός
αἰσχύ	Df	αἰσχύ
αἰσχύνην	Nb	αἰσχύνη
Αἰσχύνης	Nb	αἰσχύνη
αἰτίους	A-	αἴτιος
ἀΐων	Nb	ἀίω
ἀκέλευστος	A-	ἀκέλευστος
ἀκοάς	Nb	ἀκοάς
ἄκου’	V-	ἄκου’
ἀκούσθ	V-	ἀκούσθ
ἀκουστὸν	A-	ἀκουστός
ἄκουέ	V-	ἀκούω
ἀκούειν	V-	ἀκούω
ἀκουόντων	V-	ἀκούω
ἄκραν	Nb	ἄκρα
ἄκρου	A-	ἄκρον
ἄκρους	A-	ἄκρος
ἀκταὶ	Nb	ἀκταὶ
ἀκταῖς	Nb	ἀκτή
ἀκτὰς	Nb	ἀκτή
Ἀκτή	Nb	Ἀκτή
ἀλγεινῶς	Df	ἀλγεινός
ἄλγιστον	A-	ἄλγιστος
ἀλγίων	A-	ἀλγίων
ἀληθεῖς	A-	ἀληθής
ἀληθῆ	A-	ἀληθής
ἅλιος	Df	ἅλιος
Ἀλλ	C-	Ἀλλ
ἄλλ	C-	ἄλλ
ἀλλ’	C-	ἀλλά
ἀλλάξων	V-	ἀλλάγω
ἀλλάξαν	V-	ἀλλάξαν
ἀλλήλοις	Pc	ἀλλήλων
ἀλλήλοισιν	Pc	ἀλλήλων
ἀλλήλων	Pc	ἀλλήλων
ἀλλοδαποὺς	A-	ἀλλοδαποὺς
ἄλλοι	Px	ἄλλος
ἄλλοις	Px	ἄλλος
ἄλλος	Px	ἄλλος
ἄλλου	A-	ἄλλος
ἄλλων	A-	ἄλλος
ἄλλωι	A-	ἄλλω
ἄλλως	Df	ἄλλως
ἀλσώδεις	A-	ἀλσώδης
Ἁλώσεται	V-	Ἁλώσεται
ἅμ	R-	ἅμ
ἅμ	R-	ἅμα
ἀμαθίας	Nb	ἀμαθία
ἁμαρτήσῃ	V-	ἁμαρτάνω
ἁμαρτῆι	V-	ἁμαρτῆι
ἁμαρτήσηι	V-	ἁμαρτήσηι
ἁμαρτίας	Nb	ἁμαρτία
ἀμβολάς	Nb	ἀμβολή
ἀμείβω	V-	ἀμείβω
ἀμείνονες	A-	ἀμείνων
ἀμείνων	A-	ἀμείνων
ἀμέμπτως	Df	ἄμεμπτος
ἀμηχάνων	A-	ἀμήχανος
ἁμιλλήμαθ	V-	ἁμιλλήμαθ
ἀμπίσχων	V-	ἀμπίσχω
ἀμπτάμενα	V-	ἀμπτάμενος
ἀμύνεθ’	V-	ἀμύνεθ’
ἀμφ	R-	ἀμφ
ἀμφί	R-	ἀμφί
ἀμφιβωμίοις	A-	ἀμφιβωμίος
ἀν	R-	ἀν
ἄν	Df	ἄν
ἂν	Df	ἄν
ἄνα	x--------	ἀνά
ἀνάγετ	V-	ἀνάγετ
ἀναγκάσει	V-	ἀναγκάσει
ἀναγκάσηις	V-	ἀναγκάσηις
ἀνάγκηι	Nb	ἀνάγκηι
ἀνάγετε	V-	ἀνάγω
ἀναίδει’	F-	ἀναίδει’
ἀνακαλεῖ	V-	ἀνακαλέω
ἄναξ	Nb	ἄναξ
ἀναρπαγὰς	Nb	ἀναρπαγή
ἀνάσσηι	F-	ἀνάσσηι
ἀναστένων	V-	ἀναστένων
ἀνάσχου	V-	ἀνάσχου
ἀναφυγᾷ	Nb	ἀναφυγᾷ
ἀνδράσιν	Nb	ἀνδράσιν
ἀνειμένον	V-	ἀνειμένον
ἀνεῖρφ	V-	ἀνεῖρφ
ἀνελπίστωι	A-	ἀνελπίστως
ἀνελθὼν	V-	ἀνέρχομαι
ἀνέσπα	V-	ἀνέσπα
ἄνευ	R-	ἄνευ
ἀνευφημεῖ	V-	ἀνευφημεῖ
ἀνέχοιτ	V-	ἀνέχοιτ
ἀνέχων	V-	ἀνέχω
ἀνηιρεῖσθον	V-	ἀνηιρεῖσθον
ἀνήκεστον	A-	ἀνήκεστος
ἀνὴρ	Nb	ἀνήρ
ἀνήρου	V-	ἀνήρου
ἀνθ	G-	ἀνθ
ἀνθεμόρρυτον	A-	ἀνθεμόρρυτος
ἀνθεμώδη	Nb	ἀνθεμώδης
ἀνθρώποις	Nb	ἀνθρώποις
ἀνθρώπων	Nb	ἄνθρωπος
ἁνίκ	V-	ἁνίκμι
ἀνίστασ	V-	ἀνίστασμι
ἀνίστατε	V-	ἀνίστατε
ἀνέστησεν	V-	ἀνίστημι
ἀνοιδῆσάν	V-	ἀνοιδῆσάν
ἀνόνατον	A-	ἀνόνατος
ἄνους	A-	ἄνοος
ἀνοσίους	A-	ἀνοσῖος
ἀντ	R-	ἀντ
ἀντακούσῃ	V-	ἀντακούω
ἀντεῖχεν	V-	ἀντεῖχεν
ἀντηχήσατε	V-	ἀντηχέω
ἀντὶ	R-	ἀντί
Ἀντιγόνη	Ne	ἀντιγόνη
ἀντιτείνοντ	V-	ἀντιτείνοντ
ἀνέφερον	V-	ἀνφέρω
ἄνωγε	V-	ἄνωγα
ἄνωχθ	V-	ἄνωχθ
ἄξει	V-	ἄξει
ᾄξας	n-p---fa-	ᾄξη
ἄξι	A-	ἄξι
ἄξι	V-	ἄξι
ἀξίοισί	A-	ἀξίοισί
ἀξία	A-	ἄξιος
ἄξια	A-	ἄξιος
ἀξίων	A-	ἄξιος
ἀξιώσει	V-	ἀξιόω
ἀξιώσεται	V-	ἀξιόω
ἀξίωμ	V-	ἀξίωμ
ἄξουσιν	V-	ἄξουσιν
ἀοιδοί	Nb	ἀοιδοί
ἄοικος	Nb	ἄοικος
ἀπ	R-	ἀπ
ἀπάγγελλ	V-	ἀπάγγελλμι
ἀπάγεσθε	V-	ἀπάγεσθε
ἄπαις	Nb	ἄπαις
ἀπαιτούμεσθ’	V-	ἀπαιτούμεσθ’
ἀπαξιῶν	V-	ἀπαξιῶν
ἀπαππαπαππαῖ	F-	ἀπαππαπαππαῖ
ἀπαρθένευτ	V-	ἀπαρθένευτ
ἅπασι	Px	ἅπας
ἀπάταις	Nb	ἀπάτης
ἀπέλθεθ	V-	ἀπέλθεθ
ἀπέπτυσ’	V-	ἀπέπτυσ’μι
ἀπέπτυσα	V-	ἀπέπτυσα
ἀπεστάλης	V-	ἀπεστάλης
ἀπῆρα	V-	ἀπῆρα
ἀπιστίαι	Nb	ἀπιστία
ἀπίστωι	A-	ἀπίστωι
ἁπλοῦς	A-	ἁπλόος
Ἀπό	R-	ἀπό
ἀπὸ	R-	ἀπό
ἀφ’	R-	ἀπό
ἀποβλέπον	V-	ἀποβλέπον
ἀπολιπὼν	V-	ἀπολείπω
ἀπονοστήσας	V-	ἀπονοστέω
ἀπόξενος	A-	ἀπόξενος
ἀποπρό	R-	ἀποπρό
ἀπορίαι	Nb	ἀπορίας
ἀποσπάσας	V-	ἀποσπάζω
Ἀποσπάσας	V-	Ἀποσπάζω
ἀποτίνου	Ne	ἀποτίνου
ἀποφυγεῖν	V-	ἀποφεύγω
ἀπώλεσ	V-	ἀπώλεσ
ἀπωλόμεσθα	V-	ἀπωλόμεσθα
ἀρά	Nb	ἀρά
ἀρὰς	Nb	ἀρά
ἄρ	Df	ἄρα
ἄρα	Df	ἆρα
ἄραρεν	V-	ἀραρίσκω
Ἀργείαι	A-	Ἀργείος
Ἀργείους	A-	ἀργεῖος
Ἀργείων	A-	ἀργεῖος
Ἀργείας	Ne	Ἀργεῖος
Ἄργει	Ne	Ἄργος
ἄρειος	A-	ἄρειος
ἀρείων	A-	ἀρείων
ἀρήγετ	V-	ἀρήγετ
ἀρήγει	V-	ἀρήγω
Ἄρεος	Ne	ἄρης
ἀρίστοισιν	A-	ἄριστοισν
ἀρίσταν	A-	ἀρίστος
ἄριστα	A-	ἄριστος
ἀρίστης	A-	ἄριστος
ἀρκέσει	V-	ἀρκέσει
ἀρκοῦμεν	V-	ἀρκέω
ἁρμάτων	Nb	ἁρμάτων
ἁρμόσει	V-	ἁρμόζω
ἁρπαγῆς	Nb	ἁρπαγή
ἁρπάζητε	V-	ἁρπάζω
ἄρρητ	A-	ἄρρητ
ἀρρήτων	A-	ἀρρήτων
Ἀρτέμιδι	Ne	ἄρτεμις
ἀρχηγέτα	Nb	ἀρχηγέτα
ἀρωγοὺς	A-	ἀρωγός
ἀς	R-	ἀς
ἀσεβεῖ	A-	ἀσεβής
ἀσεβῶν	A-	ἀσεβής
ἀσθενεστέροις	A-	ἀσθενής
ἀσκεῖ	V-	ἀσκέω
ἀσκοῦντ	V-	ἀσκοῦντ
ἀστεργάνορα	A-	ἀστεργάνορος
ἀστοῖς	Nb	ἀστός
ἄστροις	Nb	ἄστρον
ἀσχημονῆσαί	V-	ἀσχημονέω
Ἀσωπιάδες	Nb	Ἀσωπιάς
ἅτ	R-	ἅτ
ἀτὰρ	Df	ἀτάρ
ἀτελῆ	A-	ἀτελής
ἀτενεῖς	A-	ἀτενής
ἄτας	Nb	ἄτη
ἀτιμάσῃς	V-	ἀτιμάζω
ἀτίται	Nb	ἀτίτης
Ἀτρέως	Nb	ἀτρεύς
ἀτταταῖ	V-	ἀτταταῖ
αὐγάς	Nb	αὐγάς
Ηὐδᾶτο	V-	αὐδάω
αὐθαίμων	Pd	αὐθαίμων
αὔλιον	Nb	αὔλιον
αὐξάνεται	V-	αὐξάνεται
αὔρας	Nb	αὔρας
ἀυτεῖ	V-	ἀυτέω
αὐτά	Pd	αὐτός
αὐτὰ	Pp	αὐτός
ἀφεγγὲς	A-	ἀφεγγής
ἀφείλεθ	V-	ἀφείλεθ
ἄφερκτος	Df	ἄφερκτος
ἄφερτα	A-	ἄφερτος
ἀφηγεῖσθαι	V-	ἀφηγέομαι
ἀφθόνῳ	A-	ἄφθονος
ἀφήσω	V-	ἀφίημι
ἀφικνεῖται	V-	ἀφικνεῖται
Ἀχαιῶν	A-	ἀχαιός
ἄχεσιν	Nb	ἄχεσιν
ἄχη	Nb	ἄχη
ἀχρεῖον	A-	ἀχρεῖος
βαδιστὴς	Nb	βαδιστής
βάθει	Nb	βάθει
βαίνουσαι	V-	βαίνω
Βακτρίων	A-	βάκτριος
Βάκτριά	Ne	Βάκτριος
βαλεῖν	V-	βαλεῖν
βαλῶ	V-	βάλλω
βάρβαρ	A-	βάρβαρ
βαρβάροις	A-	βάρβαρος
βαρβάροις	Nb	βάρβαρος
βαρβάροισι	Nb	βάρβαρος
βαρβάρου	A-	βάρβαρος
βαρβάρους	A-	βάρβαρος
βαρβάρῳ	A-	βάρβαρος
βαρβάρωι	A-	βαρβάρωι
βάρος	Nb	βάρος
βαρείας	A-	βαρύς
βασιλεῖ	Nb	βασιλεῖ
βασιλείους	A-	βασιλείους
βασιλεῖ	Nb	βασιλεύς
βασιλεῦ	Nb	βασιλεύς
βασιλεῦσιν	Nb	βασιλεύς
Βατανώχου	Ne	Βατανώχος
βάτεαι	V-	βάτεαι
βεβηκόσιν	v-prpamd-	βεβήξω
βεβώσας	v-prpafa-	βεβόω
βέλτατα	a-p---nas	βέλς
βέλτατον	a-s---nns	βέλς
βελτίους	a-p---ma-	βελτῖος
βίαι	Nb	βία
βίαι	Nb	βίαι
βιαίως	Df	βίαιος
βιοτά	Nb	βιοτά
βιοτᾶς	Nb	βιοτᾶς
βλάβηι	Nb	βλάβη
βλαστάνει	V-	βλαστάνω
βλέψαντα	v-sapama-	βλέπω
βλέψας	v-sapamn-	βλέπω
βλέψασα	v-sapafn-	βλέπω
βλεφά	Nb	βλεφά
μολόντα	v-sapama-	βλώσκω
βοὰ	V-	βοὰ
βοὰ	n-s---fn-	βοή
βοὰν	v--pna---	βοή
βοάς	n-p---fa-	βοή
βοηδρομήσας	v-sapamn-	βοηδρομέω
βοηθήσαντα	v-sapama-	βοηθέω
βολαί	n-p---fn-	βολή
βολάς	n-p---fa-	βολή
βολὰς	n-p---fa-	βολή
βόα	V-	βόος
βορὰν	n-s---fa-	βορή
βοσκὰς	n-p---fa-	βοσκή
βοστρύχους	n-p---ma-	βοστρῦχος
βοστρύχων	n-p---mg-	βοστρῦχος
βοτὰ	n-p---na-	βοτόν
βοτὰ	Nb	βοτόν
βουθύτοισι	A-	βουθύτοισι
βούλευ’	V-	βούλευ’μι
ἐβούλευσεν	V-	βουλεύω
βούληι	Nb	βούληι
ἐβούλετο	V-	βούλομαι
βοΐ	n-s---fd-	βοῦς
βουσὶ	n-p---md-	βοῦς
βραχίονα	Nb	βραχίονα
βράχιστ	A-	βράχιστ
βραχεῖ	A-	βραχύς
βρέτας	n-p---fa-	βρές
βρέτας	n-p---fa-	βρέτη
βρέτας	Nb	βρέτη
βρέτας	n-p---fa-	βρέτης
βρέτας	n-s---fn-	βρέτης
Βρομίωι	A-	Βρομίω
Βρομί	a-d---mn-	Βρομς
βροτείου	a-s---ng-	βροτεῖος
βροτείων	a-p---ng-	βροτεῖος
βροτησίων	A-	βροτησῖος
βροτοί	n-p---mn-	βροτός
βροτούς	n-p---ma-	βροτός
βρυχᾶτο	V-	βρυχάω
βύρσης	Nb	βύρση
βώμιοι	A-	βώμιος
βωμοί	n-p---mn-	βωμός
βωμούς	n-p---ma-	βωμός
γάλακτι	Nb	γάλακτι
γαλανείαι	A-	γαλανείος
γαμεῖς	V-	γαμέω
γαμεῖσθαι	V-	γαμέω
γαμή	Nb	γαμή
γάμοις	Nb	γάμοις
γάρ	Df	γάρ
γὰρ	Df	γάρ
γεγωνὰ	V-	γεγωνὰ
γενεθλίου	a-s---mg-	γενεθλῖος
γενέθλα	n-p---nv-	γενέθλον
γενείου	Nb	γένειον
γενέτα	n-s---mv-	γενέτης
γενέταν	n-s---ma-	γενέτης
γενέτας	n-s---mn-	γενέτης
γενναία	A-	γενναῖος
γενναίωι	A-	γενναίωι
γενοίμεθ	V-	γενοίμεθ
γεραιὰ	A-	γεραιός
Γερηνίου	A-	Γερήνιος
γὰν	n-s---fa-	γή
γαθεῖν	v--ana---	γθήσκω
γνώμαν	n-s---fa-	γνώμη
γνώμας	n-p---fa-	γνώμη
γνώμας	n-s---fg-	γνώμη
γνωρίμως	Df	γνωρίμως
γνωτὰ	a-p---na-	γνωτός
γοεδνά	a-p---na-	γοεδνός
γοερὰ	a-p---na-	γοερός
γοερὰ	n-p---na-	γοερός
γόνατ	Nb	γόνατ
γοναί	n-p---fv-	γονή
γοναί	n-p---fn-	γονή
γονὰς	Nb	γονή
γονὰς	n-p---fa-	γονή
Γοργόνας	n-p---fa-	Γοργόνες
γράφου	V-	γράφου
γύας	Nb	γύης
γυμνὸν	A-	γυμνός
γυναῖκα	Nb	γυνή
γυναῖκας	Nb	γυνή
γυναῖκες	Nb	γυνή
γυναικὶ	Nb	γυνή
γυναιξὶ	Nb	γυνή
γυνή	Nb	γυνή
γυψὶ	Nb	γυψὶ
δαί	x--------	δαίς
δαΐωι	F-	δαίω
δάκνει	V-	δάκνω
δάκρυ	Nb	δάκρυον
δάμαρτα	Nb	δάμαρ
Δαρείου	Ne	δαρεῖος
δέδια	v1sria---	δέδω
δείξω	V-	δείκνυμι
δειλαία	A-	δείλαιος
δειλαίωι	A-	δειλαίωι
δείπνοις	n-p---nd-	δεῖπνον
δείπνου	n-s---ng-	δεῖπνον
δεκάτωι	Mo	δεκάτωι
Δελφὶς	Ne	δελφίς
δέμας	Nb	δέμας
δέραν	Nb	δέρα
δέραν	n-s---fa-	δέρη
δέραν	v-sapamn-	δέρη
δέρας	n-p---fa-	δέρη
δέραν	n-s---ma-	δέρης
δέραν	n-s---fa-	δέρης
δεδορκότα	V-	δέρκομαι
δέσμιοι	A-	δέσμιος
δεσμίους	Nb	δέσμιος
δεσμά	n-p---na-	δεσμον
δεσμά	n-p---na-	δεσμός
δεσμὰ	n-p---nn-	δεσμός
δεσμὰ	n-p---na-	δεσμός
δεσποίναι	Nb	δεσποίναι
δεσποσίῳ	a-s---nd-	δεσποσῖος
δεσποσύνων	Nb	δεσποσύνες
δεσπόταν	n-s---ma-	δεσπότης
δεσπότας	n-p---ma-	δεσπότης
δεσποτούμενον	v-sppena-	δεσποτόω
δεσποτούμενον	v-sppema-	δεσποτόω
δεύτερ	Mo	δεύτερ
δευτέρα	Mo	δεύτερος
δεύτερον	Mo	δεύτερος
δήσας	v-sapamn-	δέω
δας	n-p---fa-	δη
δέρας	n-p---fa-	δήρ
δαρὸν	a-s---na-	δηρός
δαρὸν	a-s---nn-	δηρός
δαρὸν	a-s---ma-	δηρός
δαρὸν	n-s---ma-	δηρός
δι’	R-	διά
διὰ	R-	διά
διαγελᾶις	V-	διαγελᾶις
διάδοχά	Nb	διάδοχά
διαιρετὸν	A-	διαιρετὸς
διαπρεπεῖς	A-	διαπρεπής
διαπρέπεις	A-	διαπρέπης
διαρμόσας	V-	διαρμόζω
διαφέρων	V-	διαφέρω
διαφόρους	A-	διάφορος
διδασκάλου	Nb	διδασκάλου
δίδασκέ	V-	διδάσκω
διδάσκετε	V-	διδάσκω
διδάσκω	V-	διδάσκω
διδόντ	V-	διδόντ
διδόντες	V-	διδόντες
δίδου	V-	δίδουμι
δίδυμ	V-	δίδυμμι
διδοὺς	V-	δίδωμι
Διδοὺς	V-	δίδωμι
δίκαιαγάρ	x--------	δίκαιαγάρ
δίκαια	A-	δίκαιος
δικαίοις	A-	δίκαιος
δικαίους	A-	δίκαιος
δικαίων	A-	δίκαιος
δίκαις	Nb	δίκαις
δικαστῶν	A-	δικαστής
δίκαν	Nb	δίκη
δίκας	Nb	δίκη
διώλεσεν	V-	διόλλυμι
Διονύσωι	Ne	Διονύσω
διοπετὲς	A-	διοπετής
δίας	n-s---fg-	δῖος
δίας	a-s---fg-	δῖος
δίων	a-p---mg-	δῖος
Δίου	n-s---mg-	Δῖος
Δίου	a-s---mg-	Δῖος
Δίου	Ne	Δῖος
Διοσκόρω	Ne	Διοσκόρω
δὶς	Df	δίς
δισκηθήσεται	V-	δισκέω
δισσῶν	A-	δισσός
δίχηλον	A-	δίχηλος
διωγμοῖς	Nb	διωγμοῖς
δίωκε	V-	διώκω
δμωσὶν	n-p---md-	δμώς
δνοφερὰ	a-s---fn-	δνοφερός
δνοφεράν	a-s---fa-	δνοφερός
δεθείς	v-sappmn-	δόε
δοκείτω	v3spma---	δοκέω
δοκήσας	v-sapamn-	δοκέω
δοκούντων	v-pppamg-	δοκέω
δόξαντα	v-papana-	δοκέω
δόξας	v-sapamn-	δοκέω
κἀδόκουν	v1siia---	δοκέω
δούλην	n-s---fa-	δόλη
δολία	A-	δολίος
δολίας	a-s---fg-	δολῖος
δολίοις	a-p---md-	δολῖος
δολίῳ	a-s---md-	δολῖος
δολώσαντες	v-papamn-	δολόω
δολώσαντος	v-sapamg-	δολόω
δολώσας	v-sapamn-	δολόω
δόξαν	Nb	δόξα
δόρκα	n-s---fa-	δόρξ
δούλειον	Nb	δούλειον
δούλευε	V-	δούλευε
δούλα	A-	δούλος
δούλοις	Nb	δοῦλος
δούλοις	n-p---md-	δοῦλος
δούλοισι	n-p---md-	δοῦλος
δούλου	a-s---mg-	δοῦλος
δούλους	n-p---ma-	δοῦλος
δούλων	n-p---mg-	δοῦλος
δούλων	Nb	δοῦλος
δοχμίαν	a-s---fa-	δοχμῖος
δράσεις	V-	δράω
δρέψασθαι	v--anm---	δρέπτω
δρομὰς	n-p---fa-	δρομή
δροσερὰς	a-p---fa-	δροσερός
δρυός	n-s---fg-	δρῦς
δύναι	V-	δύναι
δυναίμεθ	V-	δυναίμεθ
δυσάρεστος	A-	δυσάρεστος
δυσγένει	A-	δυσγένει
δυσλύτους	A-	δυσλύτους
δυσμενεῖς	A-	δυσμενής
δύσνουν	V-	δύσνους
δυσσεβεστέροις	A-	δυσσεβεστέροις
δυσσεβεῖς	A-	δυσσεβής
δυσσεβῆ	A-	δυσσεβής
δύστηνον	Mo	δύστηνος
δυστυχεῖς	V-	δυστυχεῖς
δυστυχεστάτας	A-	δυστυχεστάτας
δυστυχεστάτωιπροσέπεσον	A-	δυστυχεστάτωιπροσέπεσον
δυστυχοῦντας	V-	δυστυχέω
δυστυχούντων	V-	δυστυχέω
δυστυχῶν	A-	δυστυχέω
δυστυχεῖς	A-	δυστυχής
δώματ	Nb	δώματ
δωρούμεθα	v1ppie---	δωρέω
ἐβάστασε	V-	ἐβάστασε
ἑβδόμας	a-p---fa-	ἕβδομος
τἀγγενῆ	a-p---na-	ἐγγενής
ἔγγραψον	V-	ἔγγραπτω
ἐγγράφου	V-	ἐγγράφω
ἐγγὺς	Df	ἐγγύς
ἐγείρετε	V-	ἐγείρετε
ἐγχέας	Nb	ἐγχέω
ἐγχωρίους	A-	ἐγχώριος
ἐγχωρίους	A-	ἐγχωρίους
Ἁγὼ	p-s---mn-	ἐγώ
Ἁγὼ	v1spia---	ἐγώ
ἁμὲ	d--------	ἐγώ
ἁμὲ	p-p---ma-	ἐγώ
ἄμμι	p-p---md-	ἐγώ
ἁμοὶ	p-s---fd-	ἐγώ
ἐμοί	p-s---fd-	ἐγώ
ἐμοί	p-s---md-	ἐγώ
ἐμοί	p1s---md-	ἐγώ
ἡμίν	p-p---fd-	ἐγώ
ἡμίν	p-p---md-	ἐγώ
ἡμὶν	p1p---md-	ἐγώ
ἡμὶν	p-p---fd-	ἐγώ
ἡμὶν	Pp	ἐγώ
ἡμὶν	p-p---md-	ἐγώ
Κἀγώ	p-s---fn-	ἐγώ
Κἀγὼ	p-s---fn-	ἐγώ
Κἀγὼ	p-s---mn-	ἐγώ
κἀμὲ	p-s---fa-	ἐγώ
κἀμὲ	p-p---fa-	ἐγώ
κἀμὲ	p-s---ma-	ἐγώ
κἀμοὶ	p-s---fd-	ἐγώ
κἀμοὶ	p-s---md-	ἐγώ
κἀμοὶ	p1s---md-	ἐγώ
Κἀμοὶ	p-s---md-	ἐγώ
κἀμοῦ	p-s---mg-	ἐγώ
κἀμοῦ	p-s---fg-	ἐγώ
μοί	p-s---fd-	ἐγώ
μοί	p-s---md-	ἐγώ
ἕδρας	Nb	ἕδρα
σαν	v3paia---	εδω
ἠθελησάτην	v3daia---	ἐθέλω
ἐθρέψατο	v3saim---	ἐθρέβω
εἰώθαμεν	v1pria---	ἔθω
εἰωθόσιν	v-prpamd-	ἔθω
ἴδ	v2sama---	εἶδ
εἰδείην	V-	εἰδείην
ἴδηι	v3sasa---	εἶδην
ἴδηι	v3saoa---	εἶδην
ἴδηις	v2saoa---	εἶδην
εἰδόμαν	v1siie---	εἶδον
εἰσιδών	v-sapamn-	εἶδον
ἴδε	v3saia---	εἶδον
ἴδε	v2sama---	εἶδον
ἰδεῖν	v--ana---	εἶδον
ἰδέσθαι	v--anm---	εἶδον
ἴδεσθε	v2pamm---	εἶδον
Ἴδεσθε	v2pamm---	εἶδον
ἴδετε	v2pama---	εἶδον
ἴδῃ	v3sasa---	εἶδον
ἴδῃς	v2sasa---	εἶδον
ἴδοι	v3saoa---	εἶδον
ἰδοίμην	v1saom---	εἶδον
ἴδοιμι	v1saoa---	εἶδον
Ἴδοιμι	v1saoa---	εἶδον
ἴδοις	v2saoa---	εἶδον
ἴδοιτο	v3sao----	εἶδον
ἴδον	v1saia---	εἶδον
ἰδόντα	v-sapama-	εἶδον
ἰδόντες	v-papamn-	εἶδον
ἰδοῦσα	v-sapafn-	εἶδον
ἰδοῦσιν	v-papamd-	εἶδον
ἴδω	v1sasa---	εἶδον
ἰδών	v-sapamn-	εἶδον
ἰδὼν	v-sapamn-	εἶδον
Ἰδὼν	v-sapamn-	εἶδον
ἴδωσι	v3pasa---	εἶδον
ἴθ	v2ppma---	εἶμ
ἴθ	v2spma---	εἶμ
ἐστι	V-	εἰμί
ἐστὶ	V-	εἰμί
ἔστι	V-	εἰμί
ἐστιν	V-	εἰμί
ἐστὶν	V-	εἰμί
ἔστιν	V-	εἰμί
Ἔστιν	V-	εἰμί
ὄντα	V-	εἰμί
ὠσὶν	V-	εἰμί
Εἰπὲ	v2sama---	εἶπον
Εἰπεῖν	v--ana---	εἶπον
Εἴποις	v2saoa---	εἶπον
Εἴπω	v1sasa---	εἶπον
Εἰπὼν	v-sapamn-	εἶπον
ἕνα	n-s---ma-	εἷς
ἑνὶ	r--------	εἷς
ἑνὶ	Ma	εἷς
ἑνὶ	n-s---md-	εἷς
μιᾷ	a-s---fd-	εἷς
μία	a-s---fd-	εἷς
μία	a-s---fn-	εἷς
μία	Ma	εἷς
μίαν	a-s---fa-	εἷς
μίαν	p-s---fa-	εἷς
μίαν	Ma	εἷς
μιᾶς	Ma	εἷς
μιᾶς	a-s---fg-	εἷς
Μιᾶς	a-s---fg-	εἷς
εἰσακούσας	V-	εἰσακούω
εἵσατ	V-	εἵσατ
εἴσιθ	V-	εἴσιθ
ἃκ	r--------	ἐκ
κἀκ	r--------	ἐκ
Κἀκ	r--------	ἐκ
κἀξ	r--------	ἐκ
ἑκάστῃ	A-	ἕκαστος
ἐκβαλεῖ	V-	ἐκβαλεῖ
ἐκβάλλεθ	V-	ἐκβάλλεθ
ἐκβάλληι	V-	ἐκβάλληι
ἐκβαλλόντων	V-	ἐκβαλλόντων
ἐκβαλεῖν	V-	ἐκβάλλω
ἐκβολὰν	n-s---fa-	ἐκβολή
ἐκβολὰς	n-p---fa-	ἐκβολή
ἐκδέτας	n-p---ma-	ἐκδέτης
ἐκδήσαντες	v-papamn-	ἐκδήω
ἐκδίδασκε	V-	ἐκδιδάσκω
ἐκδιδάσκει	V-	ἐκδιδάσκω
κἀκεῖ	d--------	ἐκεῖ
κἀκεῖθεν	d--------	ἐκεῖθεν
τἀκεῖθεν	d--------	ἐκεῖθεν
κἀκεῖνο	a-s---na-	ἐκεῖνο
κἀκεῖνό	a-s---ma-	ἐκεῖνό
ἐκείνας	a-p---fa-	ἐκεῖνος
ἐκείνη	Pd	ἐκεῖνος
ἐκείνη	a-s---fn-	ἐκεῖνος
ἐκείνῃ	a-s---fd-	ἐκεῖνος
ἐκείνην	Pd	ἐκεῖνος
ἐκείνην	a-s---fa-	ἐκεῖνος
ἐκείνης	a-s---fg-	ἐκεῖνος
ἐκείνοις	a-p---md-	ἐκεῖνος
ἐκείνοισιν	a-p---nd-	ἐκεῖνος
ἐκείνου	a-s---mg-	ἐκεῖνος
ἐκείνου	p-s---mg-	ἐκεῖνος
ἐκείνους	a-p---ma-	ἐκεῖνος
ἐκείνῳ	Pd	ἐκεῖνος
ἐκείνῳ	a-d---ma-	ἐκεῖνος
ἐκείνῳ	a-s---md-	ἐκεῖνος
ἐκείνων	a-p---ng-	ἐκεῖνος
ἐκείνων	Pd	ἐκεῖνος
ἐκείνων	a-p---mg-	ἐκεῖνος
κἀκεῖνος	a-s---mn-	ἐκεῖνος
Κἀκεῖνος	a-s---mn-	ἐκεῖνος
κείνας	a-p---fa-	ἐκεῖνος
κείνη	a-s---fd-	ἐκεῖνος
κείνη	a-s---fn-	ἐκεῖνος
κείνην	a-s---fa-	ἐκεῖνος
κείνης	a-s---fg-	ἐκεῖνος
κείνοιν	a-p---md-	ἐκεῖνος
κείνοις	a-p---md-	ἐκεῖνος
κείνοις	a-p---nd-	ἐκεῖνος
Κείνοις	a-p---md-	ἐκεῖνος
κείνου	a-s---mg-	ἐκεῖνος
Κείνου	a-s---mg-	ἐκεῖνος
κείνῳ	a-s---md-	ἐκεῖνος
κείνων	a-p---ng-	ἐκεῖνος
κείνων	a-p---mg-	ἐκεῖνος
τἀκείνου	a-s---ng-	ἐκεῖνος
τἀκείνου	a-s---mg-	ἐκεῖνος
τοὐκείνου	a-s---mg-	ἐκεῖνος
τοὐκείνου	a-s---ng-	ἐκεῖνος
τοὐκείνου	n-s---ng-	ἐκεῖνος
ἐκείνωι	Pd	ἐκείνωι
κἀκεῖσ	d--------	ἐκεῖσ
κἀκεῖσε	d--------	ἐκεῖσε
ἐκκέαντες	v-papamn-	ἐκκέω
ἐκκλέψας	v2saia---	ἐκκλέπτω
ἐκλελοιπότα	V-	ἐκλελοιπότα
ἐκμετρούμενος	v-sppemn-	ἐκμετρέω
ἑκόντι	V-	ἑκόντι
ἑκουσία	A-	ἑκουσίος
ἑκουσίας	A-	ἑκουσῖος
ἑκουσίωι	A-	ἑκουσίωι
ἐκπεμψαίμεθα	v1paom---	ἐκπέμπω
ἐκπέμψας	v-sapamn-	ἐκπέμπω
ἐκπεφυκότι	V-	ἐκπεφυκότι
ἐκπλήσας	v-sapamn-	ἐκπλέω
ἐκπρεπέστατος	a-s---mns	ἐκπρεπέσς
ἐκπρεπεστάτη	a-s---fns	ἐκπρεπής
ἔκραν	V-	ἔκραν
ἐκτεκνούμενος	v-sppemn-	ἐκτεκνόω
κἀκτρέποιτο	v3spoe---	ἐκτρέπω
ἐκτραφεὶς	v-sappmn-	ἐκτρέφω
ἐκτροπάς	n-p---fa-	ἐκτροπή
ἐκύρσατ	V-	ἐκύρσατ
ἐκύρωσας	V-	ἐκύρωσας
ἐκχέας	v-sapamn-	ἐκχέω
ἐκχέασα	v-sapafn-	ἐκχέω
ἐλαίας	Nb	ἐλαίας
ἐλαίωι	A-	ἐλαίωι
ἔλακες	V-	ἔλακες
ἐλάται	V-	ἐλάται
ἐλέγξας	v-sapamn-	ἐλέγγω
ἐλέγξας	v2saia---	ἐλέγσσω
Ἑλένας	n-s---fg-	Ἑλένη
ἐλεύθεροι	A-	ἐλεύθερος
ἐλεύθερον	A-	ἐλεύθερος
Ἑλλάδα	Ne	ἑλλάς
Ἑλλάδι	Ne	ἑλλάς
Ἑλλάδος	Ne	ἑλλάς
Ἑλλάνων	n-p---mg-	ἕλλην
ἐλπίδας	Nb	ἐλπίς
Ἔμβαλλε	V-	ἐμβάλλω
ἐμβατεύσετε	V-	ἐμβατεύσετε
ἐμβλέψασα	v-sapafn-	ἐμβλέπω
ἐμβολὰς	Nb	ἐμβολή
ἐμμανεῖς	A-	ἐμμανής
ἐμά	a-p---na-	ἐμός
ἐμά	a-p---nv-	ἐμός
ἐμά	a-s---fn-	ἐμός
ἐμὰ	Ps	ἐμός
ἐμὰ	a-p---na-	ἐμός
ἐμὰ	a-s---fn-	ἐμός
ἐμαί	a-p---fn-	ἐμός
ἐμάν	a-s---fa-	ἐμός
ἐμὰν	a-s---fa-	ἐμός
ἐμάς	a-p---fa-	ἐμός
ἐμὰς	a-p---fa-	ἐμός
ἐμὰς	a-s---fg-	ἐμός
ἐμούς	a-p---ma-	ἐμός
ἐμούς	Ps	ἐμός
κἀμὸν	a-s---na-	ἐμός
κἀμὸν	a-s---ma-	ἐμός
κἀμὸν	a-s---fa-	ἐμός
κἀμὸν	n-s---na-	ἐμός
τἀμὰ	p-p---nn-	ἐμός
τἀμὰ	p-p---na-	ἐμός
τἀμὰ	a-p---na-	ἐμός
τἀμὰ	a-p---nn-	ἐμός
ἐμπείροισι	A-	ἐμπείροισι
ἐμπλακεὶς	v-sappmn-	ἐμπλέκω
ἐμπορεύῃ	V-	ἐμπορεύῃ
ἐμπρήσας	v-sapamn-	ἐμπρέω
ἐμφανῶς	Df	ἐμφανής
ἐνὶ	r--------	ἐν
ἔνι	r--------	ἐν
ἔνι	d--------	ἐν
Κἀν	r--------	ἐν
τἂν	Df	ἐν
τἂν	g--------	ἐν
τἂν	l-s---fa-	ἐν
τἂν	r--------	ἐν
ἐναντίων	A-	ἐναντίος
ἐναργῆ	A-	ἐναργής
τἄνδον	d--------	ἔνδον
τἄνδον	p-s---fa-	ἔνδον
τἄνδον	n-s---fa-	ἔνδον
ἐνδυστυχῆσαι	V-	ἐνδυστυχέω
ἔνισπε	v2sama---	ἐνέπω
τἀνθένδ’	d--------	ἐνθένδ’
τἀνθένδε	p-p---na-	ἐνθένδε
τἀνθένδε	p-p---nn-	ἐνθένδε
ἐνθανεῖν	v--ana---	ἐνθνήσκω
ἐνισπεῖν	V-	ἐνισπέω
ἐννοούμενοι	v-pppemn-	ἐννοέω
ἐννυχίων	A-	ἐννύχιος
ἐνοπάν	v-sppamv-	ἐνοπή
τἀντεῦθεν	d--------	ἐντεῦθεν
ἐνυπνίων	Nb	ἐνυίνπον
ἔξαγ	V-	ἔξαγμι
ἐξάγει	V-	ἐξάγω
ἐξαγωνίζεσθε	V-	ἐξαγωνίζεσθε
ἐξαλλαγεὶς	V-	ἐξαλλαγεὶς
ἐξανισταίην	V-	ἐξανισταίην
ἐξανύτουσ	V-	ἐξανύτουσ
ἐξαπαλλάξαι	V-	ἐξαπαλλάσσω
ἐξείπῃς	v2sasa---	ἐξεῖπον
ἐξείπω	v1sasa---	ἐξεῖπον
ἐξελίξας	V-	ἐξελίγνυμι
ἐξεμούσωσεν	V-	ἐξεμουσόω
ἐξείργοι	v3spoa---	ἐξέργω
ἐξείρηκας	V-	ἐξερέω
ἐξερημώσας	v-sapamn-	ἐξερημόω
ἐξημερώσας	v-sapamn-	ἐξημερόω
ἐξικοίμεθα	V-	ἐξικοίμεθα
ἐξομιλεῖσθαι	V-	ἐξομιλέω
ἐξομόρξασθαι	v--anm---	ἐξομόρσσω
ἐξορθούμεθα	v1ppie---	ἐξορθέω
ἐξοχώτατος	a-s---mns	ἐξοχώς
ἐξηνέγκατο	v3saim---	ἐξφέρω
ἐξωθούμενον	v-sppema-	ἐξωθόω
ἑορτάς	n-p---fa-	ἑορτή
ἑορτὰς	n-p---fa-	ἑορτή
ἐπαισχυνθήσομαι	V-	ἐπαισχύνω
ἔπαλξις	Nb	ἔπαλξις
ἐπαξίων	A-	ἐπάξιος
ἐπείγεται	V-	ἐπείγεται
ἐπείγει	V-	ἐπείγω
ἐπειδὰν	G-	ἐπειδάν
ἐπίδοι	v3saoa---	ἐπεῖδον
ἐπίδοιμι	v1saoa---	ἐπεῖδον
ἐπιδὼν	v-sapamn-	ἐπεῖδον
ἐπέλασ	V-	ἐπέλασ
ἐπέμψατο	v3saim---	ἐπέμβω
ἐπισχήσω	v1sfia---	ἐπέχω
ἐπισχὼν	v-sapamn-	ἐπέχω
ἐπὶ	R-	ἐπί
ἐπίθετ	V-	ἐπίθετ
ἐπικτήσῃ	V-	ἐπικτέω
ἐπιλεχθῇς	V-	ἐπιλεχθῇς
ἐπιστενάζετε	V-	ἐπιστενάζετε
ἐπιστρέφεις	V-	ἐπιστρέφεις
ἐπιτηδεύσεις	Nb	ἐπιτηδεύσεις
τἄπη	n-p---nn-	ἔπος
τἄπη	n-p---na-	ἔπος
τἄπη	a-p---nn-	ἔπος
ἐποίσειν	v--fna---	ἐποφέρω
ἐπόψιμον	A-	ἐπόψιμος
ἐπῳδὰς	n-p---fa-	ἐπῳδή
ἐπώνυμα	A-	ἐπώνυμος
ἐπωνύμῳ	A-	ἐπώνυμος
ἐπωπάς	n-p---fa-	ἐπωπή
Ἐρασίνου	Ne	Ἐρασίνης
ἔργα	n-p---nn-	ἔργον
ἔργα	n-p---na-	ἔργον
τἄργα	n-p---na-	ἔργον
τἄργα	n-p---nn-	ἔργον
ἔρξας	v-sapamn-	ἔρδω
ἐρεθίζων	V-	ἐρεθίζω
Ἐρεχθείδαις	n-p---md-	Ἐρεχθέδης
ἐρήμα	a-p---nn-	ἐρήμος
ἐρημώσας	v-sapamn-	ἐρημώζω
ἔρις	Nb	ἔρις
ἑρκείας	a-p---fa-	ἑρκεῖος
ἑρκείου	a-s---mg-	ἑρκεῖος
ἑρκείου	a-s---fg-	ἑρκεῖος
Ἑρκείου	a-s---mg-	ἑρκεῖος
ἑρμηνευμάτων	Nb	ἑρμηνευμάτων
ἑρπούσῃ	v-sppafd-	ἕρπω
ἔρξαντες	v-papamn-	ἔρσσω
εἰρημένα	v-prpenn-	ἐρῶ
ῥηθέντα	v-pappna-	ἐρῶ
ἐσβολάν	n-s---fa-	ἐσβολή
ἐσβολὰς	n-p---fa-	ἐσβολή
ἐσιδών	v2saia---	ἐσεῖδον
ἐσθλά	a-p---na-	ἐσθλός
ἐσθλὰ	a-p---na-	ἐσθλός
ἐσθλὰς	a-p---fa-	ἐσθλός
ἐσθλούς	a-p---ma-	ἐσθλός
ἐσκέψατο	v3saim---	ἐσκέβω
ἐσπανίσμεθ	V-	ἐσπανίσμεθ
ἔσταζ	V-	ἔσταζ
ἕσταμεν	V-	ἕσταμεν
ἐστήριζε	V-	ἐστήριζε
ἑστία	a-s---fn-	ἑστῖος
ἐσφάλης	V-	ἐσφάλης
ἐσφάλης	v2saip---	ἐσφέλω
ἐσφενδόνα	n-s---fa-	ἐσφενδών
ἑταίρων	Nb	ἑταίρων
Ἐτεοκλέα	n-s---ma-	ἐτεοκλῆς
ἑτέρα	a-s---fd-	ἕτερος
ἑτέρα	a-p---na-	ἕτερος
ἑτέραν	a-s---fa-	ἕτερος
ἑτέρας	a-p---fa-	ἕτερος
θατέρου	a-s---mg-	ἕτερος
χἀτέρῳ	a-s---md-	ἕτερος
ἔταν	v3saia---	ἔτης
ἐτητύμως	Df	ἐτήτυμος
ἑτοίμους	a-p---ma-	ἑτοῖμος
ἐτράφης	v2saip---	ἐτρέφω
εὐαγγέλου	Ne	εὐαγγέλου
εὐανδρίαι	Nb	εὐανδρία
εὐδαιμονίας	Nb	εὐδαιμονία
εὐδοκίμων	A-	εὐδόκιμος
ηὔθυνε	V-	εὐθύνω
εὐλαβεστέρως	Df	εὐλαβεστέρως
εὐμαθές	A-	εὐμαθής
εὐμορφίας	Nb	εὐμορφίη
Εὐρυσθέως	Ne	Εὐρυσθέως
εὐτυχεῖς	A-	εὐτυχεῖς
εὐτυχεῖ	A-	εὐτυχέω
εὐτυχοῦντα	V-	εὐτυχέω
εὐτυχοῦντας	V-	εὐτυχέω
εὐτυχεῖς	A-	εὐτυχής
εὐτυχὴς	A-	εὐτυχής
εὐτυχὴς	A-	εὐτυχὴς
εὐτυχίαι	Nb	εὐτυχία
εὐτυχοῖτε	V-	εὐτυχοῖτε
εὐφαμεῖτ	V-	εὐφαμεῖτ
εὐφιλὴς	A-	εὐφιλὴς
εὐφραίνοισθε	V-	εὐφραίνοισθε
ἐφαίνετ	V-	ἐφαίνετ
ἐπισπέσθαι	v--anm---	ἐφέπω
ἐπίσπῃ	v2sase---	ἐφέπω
ἐφετμὰς	n-p---fa-	ἐφετμή
ἐφηβήσαντά	v-sapama-	ἐφηβήω
ἐφορμήσαντα	v-sapama-	ἐφορμέω
ἔφυσ	V-	ἔφυσ
ἐχθήρας	v-sapamn-	ἐχθεήρω
ἔχθρας	n-s---fg-	ἔχθρη
ἐχθίστης	a-s---fg-	ἐχθρός
ἔχθιστον	a-s---nn-	ἐχθρός
ἔχθιστον	a-s---ma-	ἐχθρός
Ἔχθιστον	a-s---nn-	ἐχθρός
ἐχθίστους	a-p---ma-	ἐχθρός
ἐχθρά	a-p---nn-	ἐχθρός
ἐχθρὰ	a-p---na-	ἐχθρός
ἐχθρὰ	a-s---fn-	ἐχθρός
ἐχθρὰ	a-p---nn-	ἐχθρός
ἐχθροί	a-p---mn-	ἐχθρός
ἐχθρότατον	a-s---mas	ἐχθρός
ἐχθρούς	a-p---ma-	ἐχθρός
ἐχούσαις	v-pppafd-	ἔχω
ἐχούσας	v-pppafa-	ἔχω
ἐχούσῃ	v-sppafd-	ἔχω
ζημίαις	Nb	ζημία
ζητούμενον	v-sppenn-	ζητέω
ζητητέα	a-p---na-	ζητητής
ζόας	Nb	ζόας
ζόα	n-s---fd-	ζόη
ζόαν	n-s---fa-	ζόη
ζόας	n-p---fa-	ζόη
ζόας	n-s---fg-	ζόη
ζυγόν	Nb	ζυγόν
ζυγοῖσι	Nb	ζυγός
ζουσα	v-sppafn-	ζω
ζουσι	v3ppia---	ζω
ζώνας	n-p---fa-	ζώνη
ζώσας	v-pppafa-	ζώω
ας	n-p---fa-	η
ας	a-p---fa-	η
ἡβήσαντες	v-papamn-	ἡβέω
ἥβαν	n-s---fa-	ἥβη
ἥβας	n-s---fg-	ἥβη
ἥβας	n-p---fa-	ἥβη
ἥβας	v-sapamn-	ἥβη
Ἥβας	n-p---fa-	Ἥβη
ἡβήσαντά	v-sapama-	ἡβήω
ἡγούμεθα	v1ppie---	ἡγέω
ἡγητέα	V-	ἡγητής
ἡγοίμην	v1spoe---	ἡγόω
ἡδείας	a-s---fg-	ἡδεῖος
ἥδιστα	a-p---nas	ἡδέως
ἥδιστα	a-p---na-	ἡδέως
ἠδικήθη	V-	ἠδικάω
ἡδίστων	a-p---mg-	ἡδῖστος
ἥδιστόν	A-	ἥδιστος
ἁδονὰν	n-s---fa-	ἡδονή
ἡδοναί	n-p---fn-	ἡδονή
ἡδονάς	n-p---fa-	ἡδονή
ἡδονὰς	Nb	ἡδονή
ἡδονὰς	n-p---fa-	ἡδονή
Ἤιδη	V-	Ἤιδη
Ἤιδη	Nb	Ἤιδη
ἤισχυνας	V-	ἤισχυνω
ἡλίου	Nb	ἥλιος
ἡλίωι	Nb	ἡλίωι
ἠμείψατο	V-	ἠμείψατο
ἡμένας	V-	ἡμένας
ἁμερᾶν	n-s---fa-	ἡμερᾶ
ἡμέραν	Nb	ἡμέρα
ἡμέρας	Nb	ἡμέρα
ἁμέτερα	a-p---na-	ἡμέτερος
ἁμέτερον	a-s---na-	ἡμέτερος
ἁμέτερον	a-s---nn-	ἡμέτερος
ἁμέτερον	a-s---ma-	ἡμέτερος
ἁμετέρου	a-s---mg-	ἡμέτερος
ἁμετέρων	a-p---ng-	ἡμέτερος
ἁμετέρων	a-p---mg-	ἡμέτερος
ἡμετέρας	a-s---fg-	ἡμέτερος
ἡμετέρας	a-p---fa-	ἡμέτερος
ἀμόν	a-s---ma-	ἡμός
ἀμὸν	a-s---ma-	ἡμός
ἀμὸν	a-s---na-	ἡμός
ἠμποληκότα	v-srpama-	ἠμποληκώς
ἤμυνας	V-	ἤμυνας
ἠπατώμεθα	V-	ἠπατάω
Ἥρα	V-	Ἥρα
Ἥρα	n-s---fv-	Ἥρη
Ἥρα	n-s---fn-	Ἥρη
ᾑρήκασιν	v3pria---	ᾑρήκω
Ἥρα	n-s---mv-	Ἥρης
ἠσκήσαμεν	v1paia---	ἠσκήω
ἡσσητέα	V-	ἡσσητέα
ἥσυχοι	A-	ἥσυχος
ἡσύχως	Df	ἡσύχως
ἀχῶν	v-sppamn-	ἠχέω
θαλάμας	Nb	θαλάμας
θαλαμοπόλων	Nb	θαλαμοπόλων
θαλάσσηι	Nb	θαλάσση
θάλπει	V-	θάλπω
θανάτους	Nb	θάνατος
θάψω	V-	θάπτω
θάρσος	Nb	θάρσος
θαυμάσῃ	V-	θαυμάζω
θάψω	V-	θάψω
θεαί	Nb	θεαί
θέαμ	Nb	θέαμ
θεαμάτων	Nb	θεαμάτων
θεάν	n-s---fa-	θεή
θείῳ	a-s---md-	θεῖον
θείῳ	a-s---nd-	θεῖον
θείαι	A-	θείος
θεία	a-s---fn-	θεῖος
θείᾳ	a-s---fd-	θεῖος
θείᾳ	n-s---fd-	θεῖος
θείαν	a-s---fa-	θεῖος
θείας	a-s---fg-	θεῖος
θείου	a-s---mg-	θεῖος
θείων	a-p---ng-	θεῖος
θελούσης	v-sppafg-	θελέω
θελούσας	v-pppafa-	θέλω
θεοί	n-p---mv-	θεός
θεοί	a-p---mv-	θεός
θεοί	n-p---mn-	θεός
θεούς	n-p---ma-	θεός
θεραπεῖαιἀλλὰ	Nb	θεραπεῖαιἀλλὰ
θερίζων	V-	θερίζω
θερμὰ	a-p---na-	θερμός
θερμὰ	a-p---nn-	θερμός
θερμὰν	a-s---fa-	θερμός
θερμὰς	a-p---fa-	θερμός
θεσμίοις	a-p---nd-	θεσμῖος
θεσπιέπει	V-	θεσπιέπει
θεσπίσματα	Nb	θεσπίσματα
Θηβαίοις	A-	θηβαῖος
Θήβας	n-s---fg-	θήβη
θήκας	n-p---fa-	θήκη
θηκτὰ	a-p---na-	θηκτός
θηρσὶ	n-p---md-	θήρ
θήραμα	Nb	θήραμα
Θηρατέ	V-	Θηρατέ
θηρεύου	V-	θηρεύου
θηριῶδες	A-	θηριῶδεςς
Θησέα	n-s---ma-	Θησέ
Θησέα	n-s---ma-	Θησές
ἔθανες	v2saia---	θνήσκω
θανεῖν	v--ana---	θνήσκω
Θανεῖν	v--ana---	θνήσκω
θανεῖται	v3sfim---	θνήσκω
θάνῃ	v3sasa---	θνήσκω
θάνῃς	v2sasa---	θνήσκω
θάνοι	v3saoa---	θνήσκω
θάνοιμι	v1saoa---	θνήσκω
θάνοις	v2saoa---	θνήσκω
θανόντα	v-sapama-	θνήσκω
θανόντας	v-papama-	θνήσκω
θανόντες	v-papamn-	θνήσκω
Θανόντες	v-papamn-	θνήσκω
θανόντι	v-sapamd-	θνήσκω
θανόντος	v-sapamg-	θνήσκω
θανόντων	v-papamg-	θνήσκω
θανοῦμαι	v1sfim---	θνήσκω
θανούμενος	v-sfpmmn-	θνήσκω
θανοῦσά	v-sapafn-	θνήσκω
θανούσης	v-sapafg-	θνήσκω
θανοῦσι	v-papamd-	θνήσκω
θανοῦσί	v-papamd-	θνήσκω
θανοῦσιν	v-papamd-	θνήσκω
θάνω	v3pasa---	θνήσκω
θάνω	v1sasa---	θνήσκω
θανών	v-sapamn-	θνήσκω
θανὼν	v-sapamn-	θνήσκω
θάνωσι	v3pasa---	θνήσκω
τεθνηκότα	v-srpama-	θνήσκω
τεθνηκότας	v-prpama-	θνήσκω
ἔθανε	v3saia---	θνῄσκω
θνατοῖς	a-p---md-	θνητός
θνατῶν	a-p---ng-	θνητός
θνατῶν	a-p---mg-	θνητός
θνητὰ	a-p---nn-	θνητός
θνητὰ	a-p---na-	θνητός
θνητούς	a-p---ma-	θνητός
θοὰ	a-s---fn-	θοός
θοαί	a-p---fn-	θοός
θοὰν	a-s---fa-	θοός
θοὰς	a-p---fa-	θοός
θράσει	A-	θράσει
θρασύνου	V-	θρασύνω
ἐθρέψατο	V-	θρέπτω
θρέψας	v-sapamn-	θρέπτω
θρέψασα	v-sapafn-	θρέπω
θρέψασά	v-sapafn-	θρέπω
τεθραμμένη	v-srpefn-	θρέπω
θρεομένας	v-sppefg-	θρέω
θριγκοῖς	Nb	θριγκοῖς
θροούμενος	v-sppemn-	θροέω
θρα	a-p---na-	θρος
θυγατέρας	Nb	θυγατέρας
θυγατρὸς	Nb	θυγάτηρ
θύσασι	V-	θύζω
θυμοῦσθε	V-	θυμόω
θύρετρα	Nb	θύρετρα
θύρσωι	Pi	θύρσωι
Ἰ	x--------	Ἰ
ἰαλέμωι	Ne	ἰαλέμω
Ἰάνων	Nb	Ἰάνων
ἰατρόμαντις	Nb	ἰατρόμαντις
ἰδίαι	A-	ἰδίος
ἰδόμαν	v1siie---	ἶδον
ἰδόμαν	v1saim---	ἶδον
ἵεμεν	V-	ἵεμεν
ἵετ	V-	ἵετ
ἵζει	V-	ἵζω
ἵζου	V-	ἵζω
Ἰκαρίων	A-	ἰκάριος
ἱκεσίου	A-	ἱκέσιος
ἱκετεύσατε	V-	ἱκετεύω
ἱκέτευσε	V-	ἱκετεύω
ἵλεως	Df	ἴλαος
Ἰλίωι	Ne	Ἰλίω
ἵμειρ	V-	ἵμειρ
ἵν	G-	ἵν
ἵνα	G-	ἵνα
Ἰοὺς	Nb	ἰός
ἱππικοῖσι	A-	ἱππικός
ἱρὰς	Nb	ἱρός
ἴσθ’	V-	ἴσθ’
ἴσμεν	V-	ἴσμεν
Ἰσμήν	V-	Ἰσμήν
ἰσόμοιρ	A-	ἰσόμοιρ
ἴσας	A-	ἴσος
ἱστάναι	V-	ἱστάνω
ἱστορήσωμεν	V-	ἱστορέω
ἴστω	V-	ἴστω
ἴσχειν	V-	ἴσχω
ἴτ	V-	ἴτ
Ἰφιγένειαν	Ne	Ἰφιγένεια
Ἰοῦς	Nb	ἰώ
ἰὼ	Ne	ἰώ
Ἰὼ	Nb	ἰώ
ἰωάν	x--------	ἰωάνς
ἰωιὼ	Ne	ἰωιώ
ἰώτί	x--------	ἰώτί
κτα	a-p---na-	κ
κἀγαθὰς	A-	κἀγαθός
κἀγγεγραμμέν	V-	κἀγγεγραμμέν
κἄγημας	V-	κἄγημας
Καδμείοισι	A-	Καδμεῖος
καθέσταμεν	V-	καθέσταμεν
καθεστώτων	A-	καθεστώτων
καθῆσθ	V-	κάθημ
κάθηται	V-	κάθημαι
καθήμενον	V-	καθήμενον
καθιερωμένος	V-	καθιερωμένος
καθέσταμεν	V-	καθίστημι
καταστήσας	V-	καθίστημι
καθυπερτέρα	Df	καθυπερτέρα
καί	C-	καί
καίν	Px	καίν
καίτοι	Df	καίτοι
κακανδρίαι	Nb	κακανδρία
κακίω	A-	κακίων
κἀκκομιζόντων	V-	κἀκκομιζόντων
κακὰ	A-	κακός
κακὰν	A-	κακός
κακὸν	A-	κακός
κακῶν	A-	κακός
κακῶς	Df	κακός
κακίων	A-	κακύς
καλεῖτ	V-	καλεῖτ
καλεῖτ’	V-	καλεῖτ’
καλεῖ	V-	καλέω
κάλει	V-	καλέω
καλοῦμεν	V-	καλέω
κάλλιον	A-	καλός
καλῶς	Df	καλός
καλοῦσαι	V-	καλοῦσαι
καλυμμάτων	Nb	καλυμμάτων
κάλυκος	Nb	κάλυξ
κάλωρα	A-	κάλωρα
κἀνταῦθ	Df	κἀνταῦθ
Κάνωβος	Ne	Κάνωβος
κἀξευρίσκετε	V-	κἀξευρίσκω
κἀξομοιοῦσθαι	V-	κἀξομοιόω
κἀξορθιάζων	V-	κἀξορθιάζω
κἀπ	C-	κἀπ
κἀπ	R-	κἀπ
Καπανέως	Ne	Καπανεύς
κἄπειτα	Df	κἄπειτα
κἀπεκύρωσεν	V-	κἀπεκύρωσεν
κἀπέλυσ	V-	κἀπέλυσ
κἀπικειμένας	V-	κἀπικίημι
κἀπὸ	R-	κἀπό
κἀπὸ	R-	κἀπὸ
κάρᾳ	Nb	κάρα
καρδίαι	Nb	καρδία
καρδίαν	Nb	καρδία
καρδίας	Nb	καρδία
καρτεροῦνθ	V-	καρτεροῦνθ
κἀσεβοῦντ	V-	κἀσεβοῦντ
κασιγνήτης	Nb	κασιγνήτη
κασιγνήτην	Nb	κασιγνήτην
κασιγνήτας	Nb	κασιγνήτης
κασίγνητος	Nb	κασίγνητος
κἄστ	C-	κἄστ
κἄστιν	F-	κἄστιν
καθ’	R-	κατά
κατ’	R-	κατά
κατθανὼν	V-	καταθνήσκω
κατειδόμαν	V-	κατειδόμαν
κατέκτονας	V-	κατέκτονα
κατίδετ	V-	κατίδετ
κατέστρωσεν	V-	κατό-στόρεννυμι
κάτοχον	V-	κάτοχον
κάτω	Df	κάτω
ἐκδήσαντο	v3paim---	κδήζω
κεδνὰ	a-p---na-	κεδνός
κεδνὰ	a-p---nn-	κεδνός
κεδνὰς	a-p---fa-	κεδνός
κείνοισιν	a-p---md-	κεῖνος
κείνους	p-p---ma-	κεῖνος
κείνους	a-p---ma-	κεῖνος
κεκτημένας	V-	κεκτημένας
κελεύσει	V-	κελεύσει
κελεύων	V-	κελεύω
κέλσασα	v-sapafn-	κέλζω
ἐκέλσαμεν	v1paia---	κέλλω
κέλσας	v-sapamn-	κέλω
κενά	a-p---na-	κενός
κενά	a-p---nn-	κενός
κενάς	a-p---fa-	κενός
κενὰς	a-p---fa-	κενός
κενοί	a-p---mn-	κενός
κενούς	a-p---ma-	κενός
κενώσας	v-sapamn-	κενόω
κέντρα	n-p---na-	κέντρον
κερσάμενος	v-sapmmn-	κεόρ
κεραίας	Nb	κεραία
κεραυνίους	A-	κεράυνιος
κεύθετ	V-	κεύθετ
κηλήσαντά	v-sapama-	κηλήω
κηρὶ	n-s---fd-	κήρ
κέαρ	n-s---na-	κῆρ
κέαρ	n-s---nn-	κῆρ
ΚΗΡΥΞἴυζε	V-	ΚΗΡΥΞἴυζε
ΚΗΡΥΞἰὼ	A-	ΚΗΡΥΞἰὼ
κινδύνευε	V-	κινδύνευε
κίνδυνον	Nb	κίνδυνος
κλέψας	v-sapamn-	κλέπτω
κλέψασα	v-sapafn-	κλέπτω
κλέψας	v-sapamn-	κλέφω
κληδόνα	n-s---fa-	κληδών
κληδόνας	n-p---fa-	κληδών
κλῃζομέναν	v-sppefa-	κλῄζω
κλιπεῖν	v--ana---	κλῖπον
κλοπὰς	n-p---fa-	κλοπή
κλυτὰν	A-	κλυτός
κλύετε	V-	κλύω
κάμοιμι	v1saoa---	κμήσκω
κοίλας	a-p---fa-	κοῖλος
κοίλην	a-s---fa-	κοῖλος
κοίλης	a-s---fg-	κοῖλος
κοίλῳ	a-s---nd-	κοῖλος
κοίμα	V-	κοίμα
κοινὰν	A-	κοινός
κοινὰς	A-	κοινός
κόμαν	n-s---fa-	κόμη
κόμας	n-p---fa-	κόμη
κομίζετε	V-	κομίζετε
κόμιζ	V-	κόμιζμι
κομίζετε	V-	κομίζω
κομίζου	V-	κομίζω
κομψὰ	a-p---na-	κομψός
κοντας	a-p---fa-	κοντος
κόρσας	v-sapamn-	κόρζω
κόρα	n-s---fa-	κόρη
κόρα	n-s---fn-	κόρη
κόρα	n-s---fv-	κόρη
κόραν	n-s---fa-	κόρη
κόρας	n-s---fg-	κόρη
κόρας	n-p---fa-	κόρη
κόρας	Nb	κόρη
κούρας	n-p---fa-	κόρη
Κόρας	n-s---fg-	Κόρη
κόραν	n-s---ma-	κόρης
κορύνης	Nb	κορύνη
κορυφᾷ	Nb	κορυφάω
κεσι	n-p---nd-	κος
κοσμησάμενοι	v-papmmn-	κοσμέω
κοσμήσας	V-	κοσμέω
κοσμήσας	v-sapamn-	κοσμέω
κοσμούμεθ	V-	κοσμούμεθ
κούρους	n-p---ma-	κοῦρος
κοὔτις	Ne	κοὔτις
κούφην	a-s---fa-	κοῦφος
κούφοις	a-p---nd-	κοῦφος
κπλαγῇς	v2sasp---	κπλέγω
κρατοῦντας	V-	κρατοῦντας
κρατοῦντε	V-	κρατοῦντε
κρείσσων	A-	κρείσσων
κρήνας	n-p---fa-	κρήνη
Κρησίους	A-	Κρήσιος
Κρήσσας	n-p---fa-	Κρήσση
Κρήτας	n-p---ma-	Κρήτης
Κρονίου	n-s---mg-	Κρονῖος
κρύπτει	V-	κρύπτω
κρύφιον	A-	κρύφιος
κρύψετε	V-	κρύψετε
κρύψηι	V-	κρύψηι
ἐκτείναμεν	V-	κτείνω
κτείνας	V-	κτείνω
κτείνειν	V-	κτείνω
κτένας	n-p---fa-	κτένη
κτήματος	n-s---ng-	κτήμωρ
κτησίων	A-	κτησίων
κτητὰ	n-p---na-	κτητόν
κτίσονσῳζομένων	V-	κτίσονσῳζομένων
κτάνῃ	v3sasa---	κτνήσκω
κτανόντες	v-papamn-	κτνήσκω
κτανόντι	v-sapamd-	κτνήσκω
κτανοῦσι	v-papamd-	κτνήσκω
κτανοῦσί	v-papamd-	κτνήσκω
κτάνω	v1sasa---	κτνήσκω
κυκλοῦνται	V-	κυκλοῦνται
κύκλωι	Nb	κύκλω
κύματι	Nb	κύματι
κυνέας	Nb	κυνέη
κυροῦντα	V-	κυρέω
κυρήσεις	V-	κυρήσεις
κυριωτέροις	A-	κυριός
κυρίους	Nb	κυρίους
κυρίωι	A-	κυρίωι
Κύρου	n-s---mg-	κῦρος
κύων	Nb	κύων
κωλύουσαν	V-	κωλύω
κωλύσει	V-	κωλύω
κώπας	n-p---fa-	κώπη
κὠρφανὴν	Nb	κὠρφανή
κωφὰ	a-p---nn-	κωφός
λάζυσθε	V-	λάζυσθε
λαμβάνεις	V-	λαμβάνεις
λαμπάδα	Nb	λαμπάς
λαμπρᾷ	A-	λαμπρός
λαμπρὸς	A-	λαμπρός
Λατὼ	Ne	Λατώ
Εἴρηκα	v1sria---	λέγω
Εἴρηκας	v2sria---	λέγω
λεγούσῃ	v-sppafd-	λέγω
λεγούσης	v-sppafg-	λέγω
λελεγμένα	v-prpena-	λέγω
λέξαντος	v-sapamg-	λέγω
λέξας	v2saia---	λέγω
λέξας	v-sapamn-	λέγω
λείπει	V-	λείπω
Λείπου	V-	Λείπω
λείψω	V-	λείψω
λεκτοί	a-p---mn-	λεκτος
λεκτά	a-p---nn-	λεκτός
λέκτρα	Nb	λέκτρα
λέκτρα	n-p---na-	λέκτρον
λέκτρα	n-p---nn-	λέκτρον
λέκτρα	Nb	λέκτρον
λέξαντες	v-papamn-	λέκω
λέπας	a-p---fa-	λέπη
λέπας	n-p---fa-	λέπη
λεπτὰ	a-p---na-	λεπτόν
λεπτοί	a-p---mn-	λεπτός
Λέρνας	n-s---fg-	Λέρνη
λέσχαν	n-s---fa-	λέσχη
λέσχας	n-p---fa-	λέσχη
λεύσσηις	V-	λεύσσηις
λέξασα	v-sapafn-	λέχω
λήξαντος	v-sapamg-	λήγω
λήξας	v-sapamn-	λήγω
ληξάσῃ	v-sapafd-	λήγω
Λήδα	n-s---fa-	Λήδη
Λήδα	n-s---fn-	Λήδη
Λήδας	n-s---fg-	Λήδη
Λήδας	v2spia---	Λήδη
Λήδας	n-p---fa-	Λήδη
ἐλήισατο	V-	λήιδομαι
Λήϊτος	n-s---mn-	λήῖτος
λήξαντα	v-sapama-	λήκω
Λημνία	a-s---fv-	Λημνῖος
λήξαντ	V-	λήξαντ
Λήδα	n-s---fa-	Λής
Λήδας	n-p---fa-	Λής
Λήδας	n-s---fg-	Λής
Λῃστὰς	n-p---ma-	λῃστής
Λητῴα	n-s---fn-	λητῷος
λήξασα	v-sapafn-	λήχω
λιβάνου	Nb	λιβάνος
Λιβύας	Nb	Λιβύς
λίμναι	Nb	λίμναι
λιποῦσ	V-	λιποῦσ
λιταῖς	Nb	λιτή
λιτὰς	Nb	λιτή
λιτῶν	Nb	λιτή
λόγχαν	n-s---fa-	λόγχη
λόγχας	n-s---fg-	λόγχη
λόγχας	n-p---fa-	λόγχη
λόγχα	n-p---na-	λόγχος
Λοξίαι	Ne	Λοξία
Λοξίᾳ	Ne	Λοξίᾳ
Λοξίας	Ne	λοξίας
Λοξίου	Ne	Λοξίας
Λοξίου	n-s---mg-	Λοξῖος
λοτρίας	a-s---fg-	λοτρῖος
λοχαγῶν	Nb	λοχαγή
λοχίταις	Nb	λοχίτης
λυμεὼν	V-	λυμεὼ
λύπας	Nb	λύπας
λυπῆι	Nb	λυπῆ
λύπηι	Nb	λύπη
λυπρὰ	A-	λυπρός
λώβα	n-s---fn-	λώβη
λώβαν	n-s---fa-	λώβη
λώβας	n-p---fa-	λώβη
μα	x--------	μα
μανείη	V-	μαίνω
μακαρία	Pi	μακάριος
μακαρία	A-	μακάριος
μακάριός	A-	μακάριος
μακρὰν	Df	μακράν
μακρᾶς	A-	μακρός
μακρὸν	A-	μακρός
μαλθακισθένθ	V-	μαλθακισθένθ
μάλιστά	Df	μάλιστα
μανείς	Nb	μανείς
μάνθαν	V-	μάνθαν
μανθάνουσ	V-	μανθάνουσ
μανίας	Nb	μανία
μαντείας	Nb	μαντεία
μάντεις	Nb	μάντεις
μαντεῖ	Nb	μαντῖς
μάντεων	Nb	μάντις
μαρτύριά	Nb	μαρτύριον
ματαίων	A-	μάταιος
μάταν	V-	μάτας
ματέρες	Nb	ματέρες
ματέρος	Nb	ματέρος
ματροκασιγνῆται	Nb	ματροκασιγνῆται
μάχαιραν	Nb	μάχαιρα
μάχηι	Nb	μάχηι
μέγιστον	A-	μέγας
μεγάλᾳ	a-p---na-	μέγᾳς
μεγασθενὴς	Ne	μεγασθενὴς
μέγιστον	A-	μέγιστον
μείων	V-	μείω
μελαγχαί	Nb	μελαγχαί
μέλαθρον	Nb	μέλαθρον
μελάμπεπλος	Mo	μελάμπεπλος
μελέας	a-p---fa-	μελέη
μελέα	a-p---na-	μελέος
μελέα	a-s---fv-	μελέος
μελέα	a-p---nn-	μελέος
μελέας	a-s---fg-	μελέος
μελέαν	a-s---fa-	μέλεος
μελέα	a-p---na-	μελής
μελίσσης	Ne	μέλισσα
μελλούσας	v-pppafa-	μέλλω
μελούσηι	V-	μελούσηι
μέλψασα	v-sapafn-	μέλπω
μεμπτὰ	a-p---na-	μεμπτός
μέμψασθαι	v--anm---	μέμπτω
Μενέλα	n-s---mv-	Μενέλης
Μενέλα	n-s---mg-	Μενέλης
μείναντες	v-papamn-	μένω
μείνας	v-sapamn-	μένω
μείνατε	v2pama---	μένω
μείνωσιν	v3pasa---	μένω
μερί	Nb	μερί
μέριμν	V-	μέριμν
μεσημβρίας	Nb	μεσημβρία
μέσα	a-p---nn-	μέσος
μέσας	a-p---fa-	μέσος
μέσσαν	a-s---fa-	μέσσος
μέσσαν	a-p---fg-	μέσσος
μέσσαν	n-s---fa-	μέσσος
μεταιχμίοις	A-	μεταιχμίοις
μεταλλαγαὶ	V-	μεταλλαγά
μεταρσία	A-	μεταρσίος
μεταρσίων	A-	μετάρσιος
μετασχεῖν	v--ana---	μετέχω
μετασχὼν	v-sapamn-	μετέχω
μετρούμεναι	v-pppefn-	μετρέω
μετρούμενον	v-sppema-	μετρέω
μετρίας	A-	μετρῖος
μετρίας	a-s---fg-	μετρῖος
μετρίων	a-p---ng-	μετρῖος
μέτρα	n-p---na-	μέτρον
μέχρις	G-	μέχρι
μηδένα	Px	μηδείς
μηδενὶ	Px	μηδείς
μησάμενον	v-sapmma-	μηθέω
μάκει	n-s---nd-	μῆκος
μηλείου	a-s---mg-	μηλεῖος
μηλονόμας	n-p---fa-	μηλονόμη
μάν	g--------	μήν
μάν	v2spia---	μήν
μάν	d--------	μήν
μὰν	g--------	μήν
μάτηρ	n-s---ma-	μήτηρ
μάτηρ	d--------	μήτηρ
μάτηρ	n-s---fa-	μήτηρ
μάτηρ	n-s---mn-	μήτηρ
μάτηρ	n-s---fn-	μήτηρ
Μάτηρ	n-s---fn-	μήτηρ
ματρὶ	n-s---fd-	μήτηρ
ματρὸς	n-s---fg-	μήτηρ
Ματρὸς	n-s---fg-	μήτηρ
μητέρα	n-s---fa-	μήτηρ
μητέρας	n-p---fa-	μήτηρ
μητρί	n-s---fd-	μήτηρ
μητρὶ	n-s---fd-	μήτηρ
μητρῴαν	a-s---fa-	μητρῷος
μηχανᾶσθε	V-	μηχανᾶμαι
μιᾶι	Ma	μιᾶ
μιᾶι	Ma	μιᾶι
μιγάσιν	Nb	μιγάς
μινύρεσθαι	V-	μινύρεσθαι
μισούμεθ’	V-	μισούμεθ’
μνας	n-s---fg-	μνη
μνας	Nb	μνη
μογερά	a-s---fn-	μογερός
μογερὰ	a-s---fn-	μογερός
μογερὰ	a-p---nn-	μογερός
μοίρας	Nb	μοῖρα
Μολοσσίαν	a-s---fa-	Μολοσσῖος
μολπαί	n-p---fn-	μολπή
μολπὰς	n-p---fa-	μολπή
μομφὰν	n-s---fa-	μομφή
μομφὰς	n-p---fa-	μομφή
μονα	A-	μονος
μονα	a-p---na-	μονος
μόνα	A-	μόνος
μόνα	a-d---fn-	μόνος
μόνα	a-p---na-	μόνος
μόνα	a-s---fn-	μόνος
μόναν	a-s---fa-	μόνος
μόνας	a-p---fa-	μόνος
μούνη	a-s---fn-	μόνος
μούνην	a-s---fa-	μόνος
μονούμενος	v-sppemn-	μονόω
μόραν	n-s---ma-	μόρης
μορφάς	n-p---fa-	μορφή
μορφὰς	n-p---fa-	μορφή
μορφώμασιν	Nb	μορφώμασιν
μα	d--------	μος
μα	a-p---na-	μος
μοσχείαν	a-s---fa-	μοσχεῖος
μοχθήσας	v-sapamn-	μοχθέω
μοχλεύει	V-	μοχλεύω
μα	n-s---ma-	μς
μύθοις	n-p---md-	μῦθος
μύθοισι	n-p---md-	μῦθος
μύθου	n-s---mg-	μῦθος
μύθους	n-p---ma-	μῦθος
μύθῳ	n-s---md-	μῦθος
μύθων	n-p---mg-	μῦθος
μυκήμαθ	V-	μυκήμαθ
Μυκηναίων	A-	Μυκηναίων
Μυκόνου	Ne	Μυκόνου
μυρία	A-	μυρίος
μυρίου	A-	μυρῖος
μυχόν	Nb	μυχόν
νάξεται	V-	νάγω
ναί	F-	ναί
ναί	I-	ναί
Ναί	I-	ναί
ναῒ	I-	ναῒ
ναίμνηστήρ	I-	ναίμνηστήρ
νάρθηκος	Nb	νάρθηκος
νάσου	Ne	νάσος
να	F-	νατε
νεάζων	V-	νεάζω
νεαροῖς	A-	νεαρός
νείκη	n-p---na-	νεῖκος
νείκη	n-p---nn-	νεῖκος
νείκη	a-s---fn-	νεῖκος
Νείλου	n-s---mg-	νεῖλος
νεκροί	n-p---mn-	νεκρός
νεκρούς	n-p---ma-	νεκρός
νεκρούς	A-	νεκρός
νεκρούς	a-p---ma-	νεκρός
νεμοίμην	v1spoe---	νέμω
νεογνούς	a-p---ma-	νεογνός
νεότας	n-s---fg-	νεός
νέαν	a-s---fa-	νέος
νέας	a-s---fg-	νέος
νέας	a-p---fa-	νέος
νεώτατος	a-s---mns	νέος
νεωτέρας	a-s---fgc	νέος
νερτέρας	a-p---fa-	νερτέρη
νερτέρα	a-s---fn-	νερτέρος
νεφέλας	n-p---fa-	νεφέλη
νήσαντες	v-papamn-	νέω
ναν	n-s---fa-	νη
νας	v-pppafa-	νη
νας	n-p---fa-	νη
νας	n-s---fg-	νη
νας	v-sapamn-	νη
νας	n-p---fn-	νη
νας	n-p---ma-	νη
νας	a-p---fa-	νη
νηδύν	Nb	νηδύν
νηλέα	a-p---nn-	νηλής
Νι	x--------	Νι
νικᾶι	V-	νικᾶι
νικώμενοι	V-	νικάω
νιν	Pp	νιν
νοήσας	v-sapamn-	νοέω
νοούμενος	v-sppemn-	νοέω
νομίζετ’	V-	νομίζετ’
νομίζῃ	V-	νομίζω
νομοί	n-p---mn-	νομός
ναν	n-s---fa-	νος
ναν	a-s---fa-	νος
νοσήσας	v-sapamn-	νοσέω
νοσησάσης	v-sapafg-	νοσέω
νοσούντων	v-pppamg-	νοσέω
νοσούσης	v-sppafg-	νοσέω
νοστήσας	v-sapamn-	νοστέω
νούσων	n-p---fg-	νοῦσος
νυμφείων	A-	νυμφείων
Νύμφαι	Nb	νύμφη
νύμφη	Nb	νύμφη
νυν	Df	νυν
νυ	d--------	νῦν
νύν	d--------	νῦν
σουσά	v-sapafn-	νω
ξανθῶι	A-	ξανθῶι
ξείνου	n-s---mg-	ξένος
ξείνων	a-p---mg-	ξένος
ξένα	a-p---na-	ξένος
ξέναν	a-s---fa-	ξένος
ξένας	a-s---fg-	ξένος
ξένας	a-p---fd-	ξένος
ξένας	a-p---fa-	ξένος
ξεσταί	a-p---fn-	ξεστός
ἐξεσώσαμεν	v1paia---	ξεσώλω
ξηρὰ	a-s---fn-	ξηρός
ξηραί	a-p---fn-	ξηρός
ξηρὰν	a-s---fa-	ξηρός
ξίφη	Nb	ξίφη
ξας	v2sfia---	ξλω
ξας	v2saia---	ξλω
ξας	v-sapamn-	ξλω
ξότας	n-p---fa-	ξός
ξυλουργίαν	Nb	ξυλουργίαν
ξυμμαρτυρῆις	V-	ξυμμαρτυρῆις
ξυνθήμαθ	V-	ξυνθήμαθ
ξυνίσταθ	V-	ξυνίσμθ
ἁ	p-p---nn-	ὁ
ἁ	v1spia---	ὁ
ἁ	n-s---md-	ὁ
ἁ	p-s---mn-	ὁ
ἁ	p-s---fd-	ὁ
ἁ	n-s---fn-	ὁ
ἁ	i--------	ὁ
ἁ	Pr	ὁ
ἁ	v1spsa---	ὁ
ἁ	a-p---fn-	ὁ
ἁ	p-s---fn-	ὁ
ἁ	l-s---fn-	ὁ
ἁ	g--------	ὁ
ἁ	p-p---na-	ὁ
ἁ	n-s---mn-	ὁ
Ἁ	p-s---fn-	ὁ
Ἁ	l-s---fn-	ὁ
ἃ	p-p---nn-	ὁ
Αἱ	l-p---fn-	ὁ
Οἱ	l-p---mn-	ὁ
Οἱ	p-p---mn-	ὁ
τά	l-p---na-	ὁ
τά	l-p---nn-	ὁ
τά	S-	ὁ
τά	p-p---na-	ὁ
τά	p-p---nn-	ὁ
Τά	p-p---na-	ὁ
τὰ	S-	ὁ
τὰ	l-p---nn-	ὁ
τὰ	p-p---nn-	ὁ
τὰ	l-p---na-	ὁ
τὰ	p-p---na-	ὁ
Τὰ	l-p---nn-	ὁ
Τὰ	l-p---na-	ὁ
Τὰ	S-	ὁ
ταί	V-	ὁ
τάν	p-s---fa-	ὁ
τάν	l-s---fa-	ὁ
τὰν	p-p---na-	ὁ
τὰν	l-s---fa-	ὁ
τὰν	p-s---fa-	ὁ
τάς	l-p---fa-	ὁ
τάς	p-p---fa-	ὁ
τάς	--p---fa-	ὁ
τὰς	l-p---fa-	ὁ
τὰς	p-p---fa-	ὁ
τὰς	S-	ὁ
Τὰς	l-p---fa-	ὁ
τοί	l-p---mn-	ὁ
τούς	l-p---ma-	ὁ
τούς	p-p---ma-	ὁ
Τούς	l-p---ma-	ὁ
ὀγκούμεθα	v1ppse---	ὀγκέω
Ὄγκα	n-s---fd-	Ὄγκη
Ὄγκας	n-p---fa-	Ὄγκη
ἅδ	p-s---fn-	ὅδ
τάδ	p-p---na-	ὅδ
τάδ	a-p---na-	ὅδ
τάδ	p-p---nn-	ὅδ
τάνδ	p-s---fa-	ὅδ
τάσδ	p-p---fa-	ὅδ
τούσδ	p-p---ma-	ὅδ
τούσδ	p-s---mg-	ὅδ
τάδ’	p-p---nn-	ὅδ’
τάδ’	p-p---na-	ὅδ’
τάσδ’	p-p---fa-	ὅδ’
τούσδ’	p-p---ma-	ὅδ’
ἅδε	p-s---fn-	ὅδε
Αἵδε	p-p---fn-	ὅδε
τάδε	p-p---na-	ὅδε
τάδε	u--------	ὅδε
τάδε	p-p---nn-	ὅδε
τάδε	p-s---fd-	ὅδε
Τάδε	p-p---na-	ὅδε
Τάδε	p-p---nn-	ὅδε
τάνδε	p-s---fa-	ὅδε
τάσδε	a-p---fa-	ὅδε
τάσδε	p-p---fa-	ὅδε
τάσδε	Pd	ὅδε
τούσδε	p-p---ma-	ὅδε
τούσδε	p-p---fa-	ὅδε
ὁδοί	n-p---fn-	ὁδός
ὁδούς	n-p---fa-	ὁδός
ὀδυνηρὸς	A-	ὀδυνηρός
Οἲ	Pr	Οἲ
ἴστω	V-	οἶδα
Οἰδίπους	Ne	οἰδίπους
οἰκείοις	A-	οἰκεῖος
Οἰκλέους	Nb	Οἰκλέος
Οἰκλέους	Nb	Οἰκλέους
οἰκούσηι	V-	οἰκούσηι
οἰκτίρας	V-	οἰκτείρω
οἰκτίραθ	V-	οἰκτίραθ
Οἴμ	V-	Οἴμ
οἵα	a-p---na-	οἷος
οἵα	a-p---nn-	οἷος
οἵα	a-s---fn-	οἷος
οἵα	Pr	οἷος
οἵαν	a-s---fa-	οἷος
Οἵαν	a-s---fa-	οἷος
οἵας	a-s---fg-	οἷος
οἵας	n-p---fa-	οἷος
οἵας	Pr	οἷος
οἵας	a-p---fa-	οἷος
οἵας	a-p---ma-	οἷος
ὀλβία	A-	ὀλβίας
ὀλβίας	a-s---fg-	ὀλβῖος
ὀλβίου	a-s---mg-	ὀλβῖος
ὀλβοδόταν	n-s---ma-	ὀλβοδότης
ὀλέσασα	v-sapafn-	ὀλέζω
ὠλεκόμαν	v1siie---	ὀλέκω
ὄλλυσθαι	V-	ὄλλυσθαι
ὀλοὰ	a-p---nn-	ὀλοός
ὀλοὰ	a-p---na-	ὀλοός
ὀλοὰς	a-p---fa-	ὀλοός
Ὀλύμπιοι	A-	Ὀλύμπιος
ὁμαρτεῖτ	V-	ὁμαρτεῖτ
ὁμευνέτας	Nb	ὁμευνέτης
ὁμιλίας	Nb	ὁμιλία
ὄμματα	Nb	ὄμμα
ὄμματος	Nb	ὄμμα
ὄμμασιν	Nb	ὄμμασιν
ὄμματ	Nb	ὄμματ
ὄμματα	Nb	ὄμματα
ὄμνυ	V-	ὄμνυμι
ὁμοιοτάταν	a-s---fas	ὁμοῖος
ὁμοίαις	A-	ὅμοιος
ὁμοίας	A-	ὅμοιος
ὁμοκλήσαντες	v-papamn-	ὁμοκλέω
Ὁμόλας	n-p---fa-	Ὁμόλη
ὀμφὰν	n-s---fa-	ὀμφή
ὀμφὰς	n-p---fa-	ὀμφή
ὠνείδισας	V-	ὀνειδίζω
ὀνείρων	Nb	ὄνειρος
ὀνύχων	n-p---mg-	ὀνῦχος
ὄνασθαι	v--anm---	ὄνω
ὄνασθαι	v--pne---	ὄνω
ὀπαδοί	a-p---mv-	ὀπηδός
ὁπλίζει	V-	ὁπλίζω
ὅπλα	n-p---na-	ὅπλον
ὅπλα	n-p---nn-	ὅπλον
ὅπλα	Nb	ὅπλον
ὁποίας	p-s---fg-	ὁποῖος
ὁποίας	a-s---fg-	ὁποῖος
ὁποίῳ	Pi	ὁποῖος
ὁποίῳ	a-s---md-	ὁποῖος
ὁποίωι	Pi	ὁποίωι
ὁπόσα	a-p---na-	ὁπόσος
ὀπτάς	a-p---fa-	ὀπτή
ὀργά	n-s---fn-	ὀργή
ὀργάς	n-p---fa-	ὀργή
ὀργὰς	n-p---fa-	ὀργή
ὀρέξας	v-sapamn-	ὀρέγω
ὀρεία	A-	ὀρεία
ὀρείας	Nb	ὀρεῖα
ὀρέξατε	v2pama---	ὀρέξω
Ὀρεστέρα	A-	Ὀρεστέρα
Ὀρέστα	n-s---mv-	ὀρέστης
Ὀρέστας	n-p---ma-	Ὀρέστης
ὀρθίοις	a-p---md-	ὀρθῖος
ὀρθίων	a-p---ng-	ὀρθῖος
ὀρθά	a-p---na-	ὀρθός
ὀρθὰ	a-p---na-	ὀρθός
ὀρθαί	a-p---fn-	ὀρθός
ὀρθὰς	a-p---fa-	ὀρθός
ὀρθοίη	v3spoa---	ὀρθόω
ὀρθώματα	Nb	ὀρθώματα
ὁρκωμοτήσας	v-sapamn-	ὁρκωμοτέω
ὁρμήσας	v-sapamn-	ὁρμέω
ὁρμά	n-s---fn-	ὁρμή
ὄρνιθος	Nb	ὄρνις
ὄρνις	Nb	ὄρνις
ὄρνισιν	Nb	ὄρνις
ὁρώσας	v-sapamn-	ὁρόω
ὁρώσας	V-	ὁρόω
ὀρρωδία	V-	ὀρρωδία
ὄρφνα	a-p---nn-	ὄρφνος
α	a-p---na-	ος
αν	R-	ος
ας	a-p---fa-	ος
ἅ	p-p---na-	ὅς
ἅ	p-p---nn-	ὅς
ἅ	p-s---fd-	ὅς
ἅ	n-p---mn-	ὅς
ἅ	l-s---fn-	ὅς
ἅ	g--------	ὅς
ἅ	p-s---fn-	ὅς
Ἅ	a-s---mn-	ὅς
Ἅ	p-p---na-	ὅς
ἃ	p-p---na-	ὅς
ἃ	p-p---nn-	ὅς
ἃ	i--------	ὅς
ἃ	l-s---fn-	ὅς
ἃ	p-s---fn-	ὅς
ἃ	p-s---fd-	ὅς
ἃ	Pr	ὅς
Ἃ	p-p---na-	ὅς
Ἃ	Pr	ὅς
ἃν	d--------	ὅς
ἃν	p-s---fa-	ὅς
ἃν	c--------	ὅς
ἃν	p-p---na-	ὅς
ἃν	r--------	ὅς
ἃν	g--------	ὅς
Ἃν	c--------	ὅς
ἅπερ	c--------	ὅς
ἅπερ	a-p---nn-	ὅς
ἅπερ	p-p---na-	ὅς
ἅπερ	a-p---na-	ὅς
ἅπερ	p-p---nn-	ὅς
ἅς	p-p---fa-	ὅς
ἃς	p-s---fg-	ὅς
ἃς	p-p---fa-	ὅς
ἅσπερ	p-p---fa-	ὅς
Οἵ	p-p---mn-	ὅς
ὁσία	a-s---fn-	ὁσῖος
ὁσίαν	a-s---fa-	ὁσῖος
ὁσίας	a-p---fa-	ὁσῖος
ὁσίας	a-s---fg-	ὁσῖος
ὁσίου	a-s---mg-	ὁσῖος
ὅσια	A-	ὅσιος
ὁσίων	A-	ὅσιος
ὁσιοῦσθ’	V-	ὁσιοῦσθ’μι
ὅσα	Pr	ὅσος
ὅσα	a-p---na-	ὅσος
ὅσα	a-p---nn-	ὅσος
ὅσας	a-p---fa-	ὅσος
ὅσσα	a-p---na-	ὅσος
Ὄσσας	n-p---fa-	Ὄσση
ὅσσας	a-p---fa-	ὅσση
ἥτις	Pr	ὅστις
οἵτινες	Pr	ὅστις
οἵτινές	Pr	ὅστις
ὅστις	Pr	ὅστις
ὅταν	Dq	ὅταν
ὅταν	G-	ὅταν
Ὅταν	Dq	ὅταν
ὅτι	G-	ὅτι
Οὐ	Df	οὐ
οὐχὶ	Df	οὐ
οὐδείς	Px	οὐδείς
Οὐδεὶς	Px	οὐδείς
οὐδεμία	Px	οὐδείς
Οὐδὲν	Px	οὐδείς
οὐδενὶ	Px	οὐδείς
οὐκέτι	Df	οὐκέτι
οὔριον	A-	οὔριον
ὠσὶ	n-p---nd-	οὖς
ὠσὶν	n-p---nd-	οὖς
οὕστινας	Px	οὕστις
Οὔτ	C-	Οὔτ
οὔτι	Df	οὔτι
οὔτι	x--------	οὔτι
ταύταν	a-s---fa-	οὗτον
Αὕτη	a-s---fn-	οὗτος
ταύτας	a-p---fa-	οὗτος
Ταύτας	a-p---fa-	οὗτος
ταύτῃ	a-s---fn-	οὗτος
ταύτῃ	a-s---fd-	οὗτος
Ταύτῃ	a-s---fd-	οὗτος
ταύτην	a-s---fa-	οὗτος
Ταύτην	Pd	οὗτος
Ταύτην	a-s---fa-	οὗτος
ταύτης	a-s---fg-	οὗτος
ταύτης	Pd	οὗτος
Ταύτης	a-s---fg-	οὗτος
τούτοις	a-p---nd-	οὗτος
τούτοις	p-p---nd-	οὗτος
τούτοις	a-p---md-	οὗτος
Τούτοις	a-p---md-	οὗτος
τούτοισι	a-p---nd-	οὗτος
τούτοισι	p-p---nd-	οὗτος
τούτοισι	a-p---md-	οὗτος
τούτοισί	p-p---nd-	οὗτος
τούτοισιν	a-p---nd-	οὗτος
τούτου	a-s---mg-	οὗτος
τούτου	p-s---mg-	οὗτος
τούτου	Pd	οὗτος
τούτου	a-s---ng-	οὗτος
τούτου	p-s---ng-	οὗτος
Τούτου	Pd	οὗτος
Τούτου	a-s---mg-	οὗτος
τούτους	p-p---ma-	οὗτος
τούτους	Pd	οὗτος
τούτους	a-p---ma-	οὗτος
τούτω	a-s---md-	οὗτος
τούτῳ	a-d---ma-	οὗτος
τούτῳ	a-s---nd-	οὗτος
τούτῳ	a-s---md-	οὗτος
Τούτῳ	a-s---md-	οὗτος
τούτων	p-p---ng-	οὗτος
τούτων	a-p---ng-	οὗτος
τούτων	a-p---mg-	οὗτος
τούτων	p-p---mg-	οὗτος
τούτων	Pd	οὗτος
τούτων	a-p---fg-	οὗτος
Τούτων	a-p---ng-	οὗτος
οίσεις	v2sfia---	οφέρω
ὀφθαλμὸν	Nb	ὀφθαλμός
ὄχθας	n-p---fa-	ὄχθη
ὄπα	n-s---fa-	ὄψ
ὅπα	n-s---fa-	ὅψ
ὀψοίαθ	V-	ὀψοίαθ
ὀψοίμην	V-	ὀψόω
πτα	n-p---na-	π
Πάγγαιον	Ne	παγγαῖον
παγέντας	V-	παγέντας
παιδαγώγ	Nb	παιδαγώγ
παίδων	Nb	παῖς
πακούσας	V-	πακούω
παλαιὰ	A-	παλαιός
παλαιᾷ	A-	παλαιός
παλαιὰν	A-	παλαιός
παλιγκότων	A-	παλιγκότων
παλίρρους	A-	παλίρρους
Πανδίονος	Ne	πανδίων
πάνθ	Px	πάνθ
Πάνθ	Px	Πάνθ
πανουργίας	Nb	πανουργία
πάντ	Px	πάντ
παντευχίαν	Nb	παντευχία
παπαῖ	V-	παπαῖ
παππαπαππαπαππαπαῖ	F-	παππαπαππαπαππαπαῖ
παρ’	R-	παρά
παράγει	V-	παράγω
παρακαλοῦντες	V-	παρακαλέω
παρακοπὰ	Nb	παρακοπόν
παράκτιοι	A-	παράκτιος
πάρεστι	V-	πάρειμι
παρόντα	V-	πάρειμι
παρεργάτης	Nb	παρεργάτης
πάρεσθ	V-	πάρεσθ
παρεσκευάσμεθ	V-	παρεσκευάσμεθ
παρέστω	V-	παρέστωμι
παρεστὼς	V-	παρεστὼς
παρευτρεπίζετε	V-	παρευτρεπίζω
παρέφερον	V-	παρέφερον
παρέχων	V-	παρέχω
παρηγγύων	V-	παρηγγύων
παρῆσθ	V-	παρῆσθ
παρθενίαν	Nb	παρθενία
παρθένον	Nb	παρθένον
παρθένοι	Nb	παρθένος
παρθένοις	Nb	παρθένος
παρθένον	Nb	παρθένος
παρθένους	Nb	παρθένος
παρθένωι	Nb	παρθένω
παρθενῶσι	Nb	παρθενών
Πάρις	Ne	πάρις
πάροιθεν	R-	πάροιθε
παρουσίαν	Nb	παρουσία
παροῦσιν	Ne	παροῦσιν
πάντα	Px	πᾶς
πάντα	a-s---ma-	πᾶς
πάντα	a-p---na-	πᾶς
πάντα	a-p---nn-	πᾶς
Πάντα	a-p---na-	πᾶς
πάντας	a-p---ma-	πᾶς
πάντες	a-p---mn-	πᾶς
πάντες	a-p---mv-	πᾶς
Πάντες	a-p---mn-	πᾶς
παντί	a-s---md-	πᾶς
παντί	Px	πᾶς
παντί	a-s---nd-	πᾶς
παντὶ	Px	πᾶς
παντὶ	a-s---md-	πᾶς
παντὶ	a-s---nd-	πᾶς
παντός	a-s---ng-	πᾶς
παντὸς	a-s---mg-	πᾶς
παντὸς	a-s---ng-	πᾶς
πάντων	Px	πᾶς
πάντων	a-p---ng-	πᾶς
πάντων	a-p---mg-	πᾶς
πάσαις	a-p---fd-	πᾶς
πασᾶν	a-s---fa-	πᾶς
πασᾶν	a-p---fg-	πᾶς
πάσας	a-p---fa-	πᾶς
πάσας	a-s---fg-	πᾶς
πάσῃ	a-s---fd-	πᾶς
πάσης	a-s---fg-	πᾶς
πασῶν	a-p---fg-	πᾶς
πάσηι	Px	πάσηι
πασσάλευ	V-	πασσάλευ
πάσχον	V-	πάσχω
πάσχω	V-	πάσχω
πατέρ	Nb	πατέρ
πατέρα	Nb	πατήρ
πατρί	Nb	πατήρ
πατρός	Nb	πατήρ
πατρὸς	Nb	πατήρ
πατοῖθ’	V-	πατοῖθ’μι
πατρῶια	Ps	πατρῶια
πατρώιας	A-	πατρώιας
πατρῴους	Ps	πατρῴους
παύσας	V-	παύω
πέδας	n-p---fa-	πέδη
πεδιήρεις	A-	πεδιήρεις
πεζοί	a-p---mn-	πεζός
πάθητε	v2pama---	πέθνω
Πείθου	V-	Πείθου
πείθεσθαι	V-	πείθω
πείθοι	V-	πείθω
πέλας	Df	πέλας
Πελοπίδαις	n-p---md-	Πελοπ́δης
Πελοπίας	n-s---fg-	Πελοπῖος
πέλτας	n-p---fa-	πέλτη
πεμπαστὰν	V-	πεμπαστὰν
Κἀπεμπόμην	v1siie---	πέμπω
πεμφθέντα	v-sappma-	πέμπω
πέμψαντά	v-sapama-	πέμπω
πέμψαντας	v-papama-	πέμπω
πέμψαντες	v-papamn-	πέμπω
πέμψαντος	v-sapamg-	πέμπω
πέμψας	v-sapamn-	πέμπω
πέμψασά	v-sapafn-	πέμπω
πέμψασθαί	v--anm---	πέμπω
πέμψασιν	v-papamd-	πέμπω
πέμψατε	v2paia---	πέμπω
πέμψατε	V-	πέμπω
πεμφθείς	V-	πεμφθείς
Πενθέα	Nb	Πενθέα
πενθερούς	n-p---ma-	πενθερός
πενίαι	Nb	πενία
πεπαμένῳ	V-	πεπαμένῳ
πεπλωκότα	v-srpama-	πεπλωκώς
πεπραγμέν	V-	πεπραγμέν
πέπρακται	V-	πέπρακται
πέρσας	v-sapamn-	πέρθω
περὶ	R-	περί
περίβαλε	V-	περίβαλε
περιβάλησθε	V-	περιβάλω
πέριξ	R-	πέριξ
περισσῶν	A-	περισσός
περόνας	Nb	περόνη
Περσείων	n-p---mg-	Περσεῖος
Περσέα	n-s---ma-	Περσές
Περσεφόνας	n-p---fa-	Περσεφόνη
πέρσαν	n-s---ma-	πέρσης
πέρσας	n-p---ma-	πέρσης
πέρσαντες	v-papamn-	πέρω
πέρσαντι	v-sppamd-	πέρω
πέρσαντος	v-sapamg-	πέρω
πέτρα	Nb	πέτρα
πέτρας	Nb	πέτρα
πετρούμενος	v-sppemn-	πετρέω
πετρούμενος	v-sppemn-	πετρόω
πετομένας	v-pppefa-	πέτω
πεύκας	Nb	πεύκας
πεύκᾳ	x--------	πεύκᾳς
πεφηνότι	V-	πεφηνότι
πα	n-s---fa-	πη
πηγάς	Nb	πηγάς
παγὰ	n-s---fn-	πηγή
πηγαί	n-p---fn-	πηγή
πηγὰς	n-p---fa-	πηγή
πηδαλίωι	Nb	πηδαλίω
πηδήσας	v-sapamn-	πηδέω
πηδήσασα	v-sapafn-	πηδέω
πήμασιν	Nb	πήμα
πημονὰν	n-s---fa-	πημονή
πημονὰς	n-p---fa-	πημονή
ἐπηύρου	V-	πηύρω
παθόντας	v-papama-	πθήσκω
πὶ	R-	πὶ
Πιερία	Ne	Πιερία
πικρὰν	A-	πικρός
πικρὸς	A-	πικρός
πικρῶς	Df	πικρῶς
ἔπιπτον	V-	πίπτω
πίπτει	V-	πίπτω
πὶ	x--------	πίς
πίστ	A-	πίστ
πιστεύεθ	V-	πιστεύεθ
πιστοῖσι	A-	πιστός
πιστὸν	A-	πιστός
πισχήσει	V-	πισχέω
πλανάτας	Nb	πλανάτης
πλάνωι	V-	πλάνωι
πλανώμενος	V-	πλανώμενος
πλάταις	Nb	πλάταις
πλείον	A-	πλείον
πλείστας	a-p---fa-	πλεῖστος
πλείστη	a-s---fn-	πλεῖστος
πλείστη	a-s---fd-	πλεῖστος
πλείστην	a-s---fa-	πλεῖστος
πλείστοις	a-p---md-	πλεῖστος
πλείστους	a-p---ma-	πλεῖστος
πλείστους	a-p---mas	πλεῖστος
πλείστων	a-p---mg-	πλεῖστος
πλείω	A-	πλείω
πλεκτά	a-p---na-	πλεκτός
πλεκτὰν	a-s---fa-	πλεκτός
πλεκτὰς	a-p---fa-	πλεκτός
πλεύρ’	Ma	πλεύρ’
πλευρὰν	Nb	πλευρά
πλεύσαντες	v-papamn-	πλέω
πλεύσας	v-sapamn-	πλέω
πλέα	a-p---nn-	πλέως
πληγάς	n-p---fa-	πληγή
πληγὰς	n-p---fa-	πληγή
πλημμελήσας	v-sapamn-	πλημμελέω
πληρούμενοι	v-pppemn-	πληρέω
πληρέστατον	a-s---nas	πληρής
πληρώσαντες	v-papamn-	πληρόω
πλησίον	Df	πλησίον
πληγέντα	v-sappma-	πλήσσω
πλοκάς	n-p---ma-	πλοκή
πλοκὰς	n-p---fa-	πλοκή
πλούσιός	A-	πλούσιος
πλούτου	n-s---mg-	πλοῦτος
πλούτῳ	n-s---md-	πλοῦτος
Πλούτωνος	Nb	Πλούτων
πνεύματι	Nb	πνεύματι
πνεύσας	v-sapamn-	πνέω
πνοαί	n-p---fv-	πνοή
πνοαί	n-p---fn-	πνοή
πνοάς	n-p---fa-	πνοή
πνοὰς	n-p---fa-	πνοή
πνοὰ	n-s---fa-	πνοόν
πόδα	Nb	πόδα
ποδαγὸς	n-s---mn-	ποδηγός
πόας	n-p---ma-	πόη
ποθούμεθα	v1ppie---	ποθέω
ποίαι	Pi	ποίος
ποία	a-s---fn-	ποῖος
ποίᾳ	a-s---fd-	ποῖος
ποίᾳ	a-p---na-	ποῖος
ποίαν	a-s---fa-	ποῖος
Ποίαν	a-s---fa-	ποῖος
ποίας	a-s---fg-	ποῖος
ποίας	a-p---fa-	ποῖος
Ποίας	a-s---fg-	ποῖος
Ποίας	a-p---fa-	ποῖος
ποίου	a-s---ng-	ποῖος
ποίου	a-s---mg-	ποῖος
Ποίου	a-s---mg-	ποῖος
ποίους	a-p---ma-	ποῖος
ποίῳ	a-s---md-	ποῖος
Ποίῳ	a-s---nd-	ποῖος
Ποίῳ	a-s---md-	ποῖος
πολεμίαν	n-s---fa-	πολεμῖος
πολεμίαν	a-s---fa-	πολεμῖος
πολεμίας	a-s---fg-	πολεμῖος
πολεμίας	a-p---fa-	πολεμῖος
πολεμίοισιν	a-p---md-	πολεμῖος
πολέα	a-s---fn-	πολής
πολιὰ	A-	πολιός
πόλιν	Nb	πόλις
πολιτῶν	Nb	πολίτης
πολλάκις	Df	πολλάκις
Πολυνείκη	Ne	Πολυνείκη
πολλά	A-	πολύς
πολλὰ	A-	πολύς
πολὺ	A-	πολύς
πολύν	A-	πολύς
πομπαί	n-p---fn-	πομπή
πομποί	n-p---mv-	πομπός
πομποί	n-p---mn-	πομπός
πομπούς	n-p---ma-	πομπός
πονήσας	v-sapamn-	πονέω
πονούντων	v-pppamg-	πονέω
πονηρά	a-p---nn-	πονηρός
πονηρὰ	a-p---na-	πονηρός
πονηράν	a-s---fa-	πονηρός
πονηρὰν	a-s---fa-	πονηρός
πονηρὰς	a-p---fa-	πονηρός
ποντα	n-p---na-	πονς
ποντία	a-s---fv-	ποντῖος
ποντίαισιν	a-p---fd-	ποντῖος
ποντίας	a-s---fg-	ποντῖος
ποντίας	a-p---fa-	ποντῖος
ποντίοις	a-p---nd-	ποντῖος
ποντίῳ	a-s---nd-	ποντῖος
ποντίων	a-p---ng-	ποντῖος
ποντίου	Ne	πόντιος
ποντίωι	Ne	ποντίω
ποντίωι	A-	ποντίω
πορεύ	V-	πορεύ
πορεύεθ	V-	πορεύεθ
πορεύοντες	V-	πορεύω
πορθούμεθα	v1ppie---	πορθέω
πόρπας	n-p---fa-	πόρπη
πόσιν	Nb	πόσιν
πόσι	Nb	πόσις
πόσιν	Nb	πόσις
πόσις	Nb	πόσις
πόσα	a-p---na-	πόσος
πόσας	a-p---fa-	πόσος
πότνι	R-	πότνι
ποτά	n-s---md-	ποτός
πόδα	Nb	πού
πόδα	Nb	πούς
ποσὶν	Nb	πούς
πόσιν	Nb	πούς
πεπλαγμένους	v-prpema-	ππλέγλω
πραγμάτων	Nb	πρᾶγμα
πράγη	n-p---na-	πρᾶγος
πράξω	V-	πράξω
πρέσβυς	Nb	πρέσβυς
πρὶν	G-	πρίν
προβαλοῦ	V-	προβαλοῦμι
πρόβα	v2spma---	πρόβη
προβολὰ	n-s---fn-	προβολή
προδόταν	n-s---ma-	προδότης
προδότας	n-p---ma-	προδότης
προδότας	v-papama-	προδότης
προθείς	v-sapamn-	προθέω
προθανεῖν	v--ana---	προθνήσκω
προκάμητε	V-	προκάμητε
προκηρύσσει	V-	προκηρύσσω
προνοίαι	Nb	προνοία
προοιμίοις	A-	προοιμίοις
προπέμψαντες	v-papamn-	προπέμπω
προπέμψας	v-sapamv-	προπέμπω
προπέμψατε	v2paia---	προπέμπω
προπέμψατε	v2pama---	προπέμπω
προπονουμένας	v-sppefg-	προπονέω
προπότας	n-p---ma-	προπότης
ποτι	r--------	προς
ποτὶ	r--------	πρός
προσβλέψας	v-sapamn-	προσβλέπω
προσβλέψασά	v-sapafn-	προσβλέπω
προσβολάς	n-p---fa-	προσβολή
προσβολὰς	n-p---fa-	προσβολή
προσδοκητά	V-	προσδοκητος
προσιδεῖν	v--ana---	προσεῖδον
προσείποι	v3saoa---	προσεῖπον
προσείποιμεν	v1paoa---	προσεῖπον
προσείπω	v1sasa---	προσεῖπον
προσείων	V-	προσείων
προσείη	v3spoa---	προσή
προσηγορήσας	v-sapamn-	προσηγορέω
προσίστανται	V-	προσίστημι
προσκοπούμενος	v-sppemn-	προσκοπέω
προσκυνοῦντες	V-	προσκυνέω
προσκυνοῦνθ	V-	προσκυνοῦνθ
προσόντα	V-	προσόντα
προσπέμψαντά	v-sapama-	προσπέμπω
προσπέμψας	v-sapamn-	προσπέμπω
προσστείχοντα	V-	προσστείχω
προστραπέσθαι	v--anm---	προστρέπω
προσφωνούμεθα	v1ppie---	προσφωνέω
προσωτάτω	d--------	πρόσω
προτέρα	a-s---fn-	προτέρος
προτέραν	a-s---fa-	πρότερος
προτέρας	a-p---fa-	πρότερος
πρώτας	a-p---fas	πρότερος
προτιμήσῃς	V-	προτιμέω
προφητεύσει	V-	προφητεύω
προφήτας	n-p---ma-	προφήτης
προχοὰς	n-p---fa-	προχοή
πρώτα	a-p---nas	πρώτος
πρώτα	a-p---na-	πρώτος
πρώτας	a-p---fa-	πρῶτος
πτέρυγι	Nb	πτέρυγ
πτερωτὰ	a-p---na-	πτερωτός
πτερωτὰ	a-p---nn-	πτερωτός
πτερωτὰς	a-p---fa-	πτερωτός
πτήξας	v-sapamn-	πτήζω
πτανοῖς	v2saoa---	πτηνός
πτωχὰς	a-p---fa-	πτωχός
Πύλου	Ne	πύλος
πυρί	n-s---nd-	πῦρ
πυρὶ	Nb	πῦρ
πυρὶ	n-s---nd-	πῦρ
πυρός	n-s---ng-	πῦρ
πυρὸς	n-s---ng-	πῦρ
πύργωμα	Nb	πύργωμα
πυρί	Nb	πυρί
ῥάιδια	V-	ῥάιδια
ῥέξας	v-sapamn-	ῥέδω
Ῥέας	n-s---fg-	Ῥέη
Ῥέας	v-sapamn-	Ῥέη
ῥείθροισι	n-p---nd-	ῥεῖθρον
ῥείτω	v3spma---	ῥέω
ῥεούσης	v-sppafg-	ῥέω
ρήναν	n-s---fa-	ρήνη
ῥήξασα	v-sapafn-	ῥήσσω
ῥητά	a-p---na-	ῥητος
ῥίζας	Nb	ῥίζα
ῥίζωμ	Nb	ῥίζωμ
ῥινηλατούσῃ	V-	ῥινηλάτω
ῥίπτετ	V-	ῥίπτετ
ῥίπτων	V-	ῥίπτων
ῥοαί	n-p---fv-	ῥοή
ῥοαί	n-p---fn-	ῥοή
ῥοάς	n-p---fa-	ῥοή
ῥοὰς	Nb	ῥοή
ῥοὰς	n-p---fa-	ῥοή
ῥοπάς	Nb	ῥοπάς
ροισι	n-p---md-	ρος
ῥύεσθε	V-	ῥύεσθε
ῥυσίων	Nb	ῥύσιος
ῥυσίου	A-	ῥυσίου
δα	n-s---fa-	ς
σιν	d--------	ς
σιν	n-s---fa-	ς
σιν	v-papamd-	ς
σιν	v3ppia---	ς
σιν	n-p---fd-	ς
σα	Ps	σα
σαγή	Nb	σαγή
σάλου	Nb	σάλος
σαρκὶ	Nb	σάρξ
σας	A-	σας
σατίνας	Nb	σατίνη
σάφ	Df	σάφ
σαφεστέρας	A-	σαφεστέρας
σαφῆ	A-	σαφής
σαφῶς	Df	σαφής
σεβίζῃ	V-	σεβίζω
σελήνας	Nb	σελήνας
σελήνας	n-p---fa-	σελήνη
Σεμέλας	n-p---fa-	Σεμέλη
Σεμέλας	n-s---fg-	Σεμέλη
σεμνά	a-s---fn-	σεμνός
σεμνὰ	a-p---nn-	σεμνός
σεμνὰ	a-p---na-	σεμνός
σεμνὰ	a-s---fn-	σεμνός
σεμναί	a-p---fn-	σεμνός
σεμνὰν	a-s---fa-	σεμνός
σεμνάς	a-p---fa-	σεμνός
σεμνὰς	a-p---fa-	σεμνός
σεμνοί	a-p---mn-	σεμνός
σεσωφρονισμένως	Df	σεσωφρονισμένως
σήραντες	v-papamn-	σήρω
σιγᾶις	V-	σιγᾶις
ἐσιγήθη	V-	σιγάω
σιγώσῃ	V-	σιγώω
σκάπτει	V-	σκάπτω
σκηνάν	n-s---fa-	σκηνή
σκηνάς	n-p---fa-	σκηνή
σκηνὰς	n-p---fa-	σκηνή
σκήψας	v-sapamn-	σκήπτω
σκήψασα	v-sapafn-	σκήπτω
σκληρά	a-s---fv-	σκληρός
σκληρὰ	a-p---na-	σκληρός
σκληρὰ	a-p---nn-	σκληρός
σκληρὰν	a-s---fa-	σκληρός
Σκληρὰν	a-s---fa-	σκληρός
σκοπεύουσα	V-	σκοπεύω
σκοπούμενοι	v-pppemn-	σκοπέω
σκοπιὰς	Nb	σκοπιὰ
σκοποί	n-p---mn-	σκοπός
σκοπούς	n-p---ma-	σκοπός
σκοτίους	a-p---ma-	σκοτῖος
Σκύθης	Nb	σκύθης
σκύλοις	n-p---nd-	σκῦλον
σκύμνον	Nb	σκύμνος
σαν	a-s---fa-	σος
σά	a-p---nn-	σός
σά	a-p---na-	σός
σὰ	a-p---nn-	σός
σὰ	a-p---na-	σός
σὰ	a-s---fn-	σός
σὰν	a-s---fa-	σός
σὰν	n-s---fa-	σός
σάς	a-p---fa-	σός
σὰς	a-s---fg-	σός
σὰς	a-p---fa-	σός
σούς	a-p---ma-	σός
σοφιστῆι	Nb	σοφιστῆς
σοφά	a-s---fn-	σοφός
σοφά	a-p---na-	σοφός
σοφά	a-p---nn-	σοφός
σοφὰ	a-p---na-	σοφός
σοφὰ	a-p---nn-	σοφός
σοφαί	a-p---fn-	σοφός
σοφὰν	a-s---fa-	σοφός
σοφὰς	a-p---fa-	σοφός
σοφοί	a-p---mn-	σοφός
σοφούς	a-p---ma-	σοφός
σοφώτατον	a-s---nns	σοφός
σοφωτέρα	A-	σοφωτέρα
σπάργαν	Nb	σπάργαν
σπάσαν	V-	σπάσαν
σπασμοῖσι	Nb	σπασμοῖσι
σπερχνούς	a-p---ma-	σπερχνός
σπεύδετε	V-	σπεύδω
σπεύδομεν	V-	σπεύδω
σποδούμενος	v-sppemn-	σποδέω
σποδούμενος	v-sppemn-	σποδόω
σπονδαί	n-p---fn-	σπονδή
σπονδάς	n-p---fa-	σπονδή
σπονδὰς	n-p---fa-	σπονδή
σπουδάζομεν	V-	σπουδάζω
σπουδαί	A-	σπουδός
ἔσταζεν	V-	στάζω
σταθμὰ	Nb	σταθμὰ
στέγας	n-p---fa-	στέγη
στέγας	n-s---fg-	στέγη
στέγας	Nb	στέγη
στέγα	n-p---nn-	στέγον
στάθητε	v2paip---	στέθνω
στείχοντα	V-	στείχω
Στείχοντα	V-	στείχω
στείχω	V-	στείχω
Στείχων	V-	Στείχω
ἐστάλη	v3saip---	στέλλω
ἐστάλην	v1saip---	στέλλω
ἐσταλμένον	v-srpenn-	στέλλω
ἐστειλάμην	v1saim---	στέλλω
στείλαντες	v-papamn-	στέλλω
στείλαντος	v-sapamg-	στέλλω
στέναζ’	V-	στέναζ’μι
στενάζειν	V-	στενάζω
στέψασα	v-sapafn-	στέπω
στέρξας	v-sapamn-	στέργω
στερεὰ	a-p---na-	στερεός
στερηθείς	v-sappmn-	στερέω
στέρνα	Nb	στέρνον
στέρνα	n-p---na-	στέρνον
στέρνα	n-p---nn-	στέρνον
στερρὰ	n-p---na-	στερρός
στεφαναφόρει	Nb	στεφαναφόρε
στέψαντες	v-papamn-	στέφω
ἐστήσαμεν	v1paia---	στέω
στηρίζῃ	V-	στηρίζῃ
στιν	V-	στιν
στωσιν	v3ppsa---	στνω
στολάς	n-p---fa-	στολή
στολὰς	n-p---fa-	στολή
στολμοί	n-p---mn-	στολμος
στολμούς	n-p---ma-	στολμός
στόμα	Nb	στόμα
στα	v1saia---	στος
στράτευμ	Nb	στράτευμ
στρατεύματος	Nb	στρατεύματος
στρατηγὸν	Nb	στρατηγός
στρατηγῶν	Nb	στρατηγῶν
στρατηλάτηι	Nb	στρατηλάτηι
στρέψασα	v-sapafn-	στρέπω
στραφείη	v3saop---	στρέφω
στραφείην	v1saop---	στρέφω
στραφεὶς	v-sappmn-	στρέφω
στραφέντες	v-pappmn-	στρέφω
στρέψας	v-sapamn-	στρέφω
στροφὰς	n-p---fa-	στροφή
στρωτὰ	a-p---na-	στρωτός
στρωτὰ	a-p---nn-	στρωτός
στύγους	Nb	στύγους
σύ	Pp	σύ
σὺ	Pp	σύ
Σὺ	Pp	σύ
συγγενείας	Nb	συγγενείας
συγγενέτειρ	A-	συγγενέτειρ
συγγόνωι	A-	συγγόνωι
συγγόνων	A-	συγγόνων
συγκατασκάψων	V-	συγκατασκάψων
συγκόλλως	Df	σύγκολλος
συληθήσεται	V-	συληθήσεται
συμμαρτυρήσεις	V-	συμμαρτυρέω
συμμάχοις	A-	σύμμαχος
συμφορά	Nb	συμφορά
συμφορὰ	Nb	συμφορά
συμφοραῖς	Nb	συμφορά
συμφορὰς	Nb	συμφορά
συμφορᾶς	Nb	συμφορά
συμφορὰς	Nb	συμφορὰ
συμφορᾶι	Nb	συμφορᾶ
συμφορᾶς	Nb	συμφορᾶς
σὺν	R-	σύν
συνάγαγεν	V-	συνάγαγεν
συνεκτραφεὶς	V-	συνεκτρέφω
συνεξαίρει	A-	συνεξαίρες
συνεργοὺς	A-	συνεργός
συνῆψ	V-	συνῆψ
συντιθεὶς	V-	συντιίημθ
σύντομ	V-	σύντομ
συντόμως	Df	σύντομος
συντυχὼν	V-	συντυχάνω
Συρίας	Ne	συρία
σφαγείς	Nb	σφαγείς
σφαγεὶς	Nb	σφαγεὶς
σφαγὰς	Nb	σφαγή
σφαγίων	Nb	σφάγιον
σφάγιον	A-	σφάγιος
σφαλεῖσ	V-	σφαλεῖσ
σφαλερῶς	Df	σφαλερός
σφαγήσεται	v3sfim---	σφέγω
σφας	p-p---ma-	σφεῖς
σφας	p-p---fa-	σφεῖς
σφιν	p-p---md-	σφεῖς
σφισιν	p-p---md-	σφεῖς
σφίσιν	p-p---md-	σφεῖς
σφαλεὶς	v-sappmn-	σφέλω
σφενδόνας	n-p---fa-	σφενδόνη
σχετλίων	A-	σχετλῖος
σαντες	v-papamn-	σω
σεσωσμένα	v-prpena-	σώζω
σώσαντι	v-sapamd-	σώζω
σώσας	v-sapamn-	σώζω
σώσασα	v-sapafn-	σώζω
σώσατε	v2pama---	σώζω
σώσαντος	v-sapamg-	σῴζω
σώματος	Nb	σῶμα
σώμασίν	Nb	σώμασίν
σώματι	Nb	σώματι
σωτηρίων	a-p---ng-	σωτηρῖος
σωτηρίους	A-	σωτηρίους
σωφρονεστάτης	A-	σωφρονής
σωφρονέστατον	a-s---mas	σώφρων
σώσατέ	v2pama---	σώω
τα	S-	τα
τἀκεῖ	V-	τἀκέω
τἄμπαλίν	Nb	τἄμπαλίν
τἀν	S-	τἀν
τἀναντί	R-	τἀναντί
τἀνόντα	V-	τἀνόντα
τἀντεταλμέν	V-	τἀντεταλμέν
τἀπ	R-	τἀπ
τἄρ	Pp	τἄρ
ταρβεῖ	V-	ταρβεῖ
ταρβεῖν	V-	ταρβέω
ταρβῶ	V-	ταρβέω
ταφείσας	V-	ταφείθω
ταφέντ	V-	ταφέντ
ταφεὺς	Nb	ταφεὺς
τάφωι	V-	τάφωι
τάχυν’	A-	τάχυν’
τέγξας	v-sapamn-	τέγσσω
τεθνηκόσιν	v-prpamd-	τεθνήξω
τεθρίπποις	A-	τεθρίππος
τέθριππος	A-	τέθριππος
τείχεα	n-p---na-	τεῖχος
τείχει	Nb	τεῖχος
τείχεος	n-s---ng-	τεῖχος
τείχεσι	n-p---nd-	τεῖχος
τείχεσιν	n-p---nd-	τεῖχος
τείχη	n-p---na-	τεῖχος
τείχη	n-p---nn-	τεῖχος
τέκνα	n-p---nn-	τέκνον
τέκνα	Nb	τέκνον
τέκνα	n-p---nv-	τέκνον
τέκνα	n-p---na-	τέκνον
ἐτεκνώσατο	v3saim---	τεκνόω
τεκνούμενον	v-sppema-	τεκνόω
τεκόντι	v-sppamd-	τεκός
Τελαμών	Nb	τελαμών
τελεία	a-s---fn-	τελεῖος
τελείας	a-s---fg-	τελεῖος
τελείου	a-s---mg-	τελεῖος
τελεσφόρα	a-p---na-	τελεσφόρος
τελετάς	n-p---fa-	τελετή
τελετὰς	n-p---fa-	τελετή
τελέαν	v--pna---	τελέω
τελέσαντα	V-	τελέω
τελέσας	v-sapamn-	τελέω
τελέσασιν	v-papamd-	τελέω
Τεάν	a-s---fa-	τεός
τερπνά	a-p---na-	τερπνός
τερπνὰ	a-p---nn-	τερπνός
τερπνὰ	a-p---na-	τερπνός
τερπνὰς	a-p---fa-	τερπνός
τετάγμεθ	V-	τετάγμεθ
τεταγμένου	V-	τεταγμένου
τεταγμένῳ	V-	τεταγμένῳ
τετραβάμοσι	A-	τετραβάμων
Τεύκρου	n-s---mg-	τεῦκρος
Τεύκρῳ	n-s---md-	τεῦκρος
τεύχεα	n-p---na-	τεῦχος
τεύχει	n-s---nd-	τεῦχος
τεύχεσιν	n-p---nd-	τεῦχος
τεύχη	v3spia---	τεῦχος
τεύχη	v3sfia---	τεῦχος
τεύχη	n-p---na-	τεῦχος
τεύχη	n-p---nn-	τεῦχος
ταφέντες	v-pappmn-	τέφω
ταφῆναι	v--anp---	τέφω
τεχνάσματα	Nb	τεχνάσματα
τέχνας	n-p---fa-	τέχνη
τέχνας	n-s---fg-	τέχνη
τέχνα	n-s---fn-	τέχνος
τας	v-sapamn-	τη
τας	a-p---fa-	τη
τας	p-s---fg-	τη
τας	n-p---fa-	τη
τας	n-s---fg-	τη
τάκομαι	v1spie---	τήκω
τακόμενοι	v-pppemn-	τήκω
τηλικόσδ	Pd	τηλικόσδ
τηνικαῦθ	Pd	τηνικαῦθ
τηρήσας	v-sapamn-	τηρέω
τι	x--------	τι
τεκόντας	V-	τίκτω
τιμᾶι	V-	τιμᾶι
τίμημα	Nb	τίμημα
τιμώμεν	V-	τιμώμεν
τιν	Px	τιν
τίνες	Pi	τίνες
τι	Pi	τις
τι	x--------	τις
τί	Pi	τίς
τί	x--------	τίς
Τίς	Pi	τίς
τι	Px	τὶς
τινα	Px	τὶς
τις	Px	τὶς
τλημονεστάτην	a-s---fas	τλημονής
τλημονέστατον	a-s---mas	τλημονής
τλάμων	n-s---mv-	τλήμων
τλάμων	n-s---fn-	τλήμων
τλάμων	n-p---mg-	τλήμων
τλάμων	n-s---mn-	τλήμων
τλάμων	n-s----n-	τλήμων
τλημονεστάτη	a-s---fns	τλήμων
τλησικάρδιος	A-	τλησικάρδιος
τλά	a-p---na-	τλος
τοιάδ	Pd	τοιάδ
τοιγάρ	Df	τοιγάρ
τοιγὰρ	Df	τοιγάρ
Τοιγὰρ	Df	τοιγάρ
τοίαν	a-s---fa-	τοῖος
τοίας	a-p---fa-	τοῖος
τοιάδε	Pd	τοιόσδε
τοιούτοις	Pd	τοιοῦτος
τοιούτου	Pd	τοιοῦτος
τόλμα	V-	τόλμα
τόλμας	v2spia---	τόλμη
τολμητά	a-p---nn-	τολμητός
τὸνπάθει	V-	τὸνπάθει
τόξα	n-p---nn-	τόξον
τόξα	n-p---na-	τόξον
τα	p-p---na-	τος
τα	a-p---na-	τος
ταν	a-s---fa-	τος
τόσα	a-p---na-	τόσος
τόσα	d--------	τόσος
τοσούσδε	a-p---ma-	τοσόσδε
τοσαύτην	a-s---fa-	τοσοῦτος
τοσαύτης	a-s---fg-	τοσοῦτος
τοσούτου	a-s---mg-	τοσοῦτος
τοσούτων	a-p---ng-	τοσοῦτος
τρία	m-p---nn-	τρεῖς
τρισὶ	m-p---md-	τρεῖς
τρισὶν	Ma	τρεῖς
τριῶν	m--------	τρεῖς
τριῶν	Ma	τρεῖς
τριῶν	a-p---mg-	τρεῖς
τριῶν	a-p---fg-	τρεῖς
τετραμμένου	v-srpemg-	τρέπω
τράπε	n-s---fa-	τρέπω
τραπεὶς	v-sappmn-	τρέπω
τραπέσθαι	v--anm---	τρέπω
τραπόμενος	v-sapmmn-	τρέπω
θρεψαίμην	v1saom---	τρέφω
τεθραμμένον	v-srpema-	τρέφω
τεθραμμένον	v-srpena-	τρέφω
τραφεὶς	v-sappmn-	τρέφω
τράφη	v3saip---	τρέφω
τραφῆναι	v--anp---	τρέφω
τράφης	v2saip---	τρέφω
δραμοῦσα	v-sapafn-	τρέχω
δραμὼν	v-sapamn-	τρέχω
ἔδραμε	v3saia---	τρέχω
τρέσαντα	v-sapama-	τρέω
τρέσας	v-sapamn-	τρέω
τρίβων	V-	τρίβω
τρίγονοι	A-	τρίγονος
τρίτον	Mo	τρίτος
τριχὸς	A-	τριχὸς
Τροία	Ne	τροία
Τροίαι	Ne	Τροία
τρομερὰ	a-p---na-	τρομερός
τρομερὰ	a-p---nn-	τρομερός
τρομερὰν	a-s---fa-	τρομερός
τροπὰς	n-p---fa-	τροπή
τροφαί	n-p---fn-	τροφή
τροφάς	n-p---fa-	τροφή
τροφὰς	n-p---fa-	τροφή
τροφοί	n-p---fn-	τροφός
Τροφωνίου	n-s---mg-	Τροφωνῖος
τροχοί	n-p---mn-	τροχός
τρῴας	n-p---ma-	τρῴ
Τρωίας	a-p---fa-	Τρωῖος
Τρωσί	n-p---md-	τρώς
Τρωσίν	n-p---md-	τρώς
τρώσασαν	v-sapafa-	τρώω
τεύξεται	V-	τυγχάνω
Τυνδαρὶς	Ne	Τυνδαρὶς
τυραννίδι	Nb	τυραννίς
τύραννος	Nb	τύραννος
τυφλωθὲν	V-	τυφλωθὲν
τυφὼς	Nb	τυφώς
τύχηι	Nb	τύχηι
τύχοιτε	V-	τύχω
ὕβριζ	V-	ὕβριζ
ὑβρισμέν	V-	ὑβρισμέν
ὑβρισταί	Nb	ὑβρισταί
ὑβριστὴς	Nb	ὑβριστής
ὑδάτων	Nb	ὕδωρ
ὕλης	Nb	ὕλη
Ὕλλος	Ne	ὕλλος
ὑμᾶς	Pp	ὑμεῖς
ὑμῖν	Pp	ὑμεῖς
Ὑμῖν	Pp	ὑμεῖς
Ὑμέναι	F-	Ὑμέναι
ὑμνωιδεῖ	V-	ὑμνωιδεῖ
Ὑμήν	Pp	ὑμός
ὕπατοί	A-	ὕπατος
ὑπ’	R-	ὑπό
ὑπὸ	R-	ὑπό
ὑφ’	R-	ὑπό
συὸς	n-s---mg-	ὗς
ὑστέρου	A-	ὑστέρος
ὕστερον	A-	ὕστερος
ὑστέρωι	A-	ὑστέρωι
ὕφασμ	V-	ὕφασμ
ὑφέρπει	V-	ὑφέρπω
ἐφαίνετο	V-	φαίνω
φανερὸς	A-	φανερός
φανερώτατον	A-	φανερώς
φαρμάκων	Nb	φαρμάκον
φάρη	n-p---na-	φᾶρος
φας	x--------	φας
φά	Nb	φάς
φασγάνωι	Nb	φασγάνω
φάσματα	Nb	φάσμα
φασμάτων	Nb	φάσμα
φάτιν	Nb	φάτις
φανείη	v3saop---	φένω
φανεὶς	v-sappmn-	φένω
φερνάς	n-p---fa-	φερνή
φερνὰς	n-p---fa-	φερνή
φερνὰς	a-p---fa-	φερνός
Φερσεφόνας	n-p---ma-	Φερσεφόνες
φερούσας	v-pppafa-	φέρω
φεύγεις	V-	φεύγεις
φεύγετ’	V-	φεύγετ’
φεύγειν	V-	φεύγω
φάμα	n-s---fn-	φήμη
Φάμα	n-s---fv-	φήμη
φήμας	n-p---fa-	φήμη
φήνασθαι	v--pne---	φήνω
φθάνειν	V-	φθάνω
φθείρου	V-	φθείρου
φθαρέντες	v-pappmn-	φθέρω
φθάνοις	v2saoa---	φθνήσκω
φθογγὰ	n-s---fn-	φθογγή
φθογγάς	n-p---fa-	φθογγή
φθογγὰς	n-p---fa-	φθογγή
φθονερὰν	a-s---fa-	φθονερός
φθονήσας	v-sapamn-	φθονέω
Φιλοκτήτης	Nb	φιλοκτήτης
φίλα	A-	φίλος
φίλοις	A-	φίλος
φίλοισι	A-	φίλος
φίλον	A-	φίλος
φίλτατον	A-	φίλος
φίλως	Df	φίλος
φιλοψυχοῦσ	V-	φιλοψυχοῦσ
φιλτάτους	A-	φίλς
φιλτάτης	A-	φιλτάτης
φιλτάτοις	A-	φιλτάτοις
φιλτάτου	A-	φίλτατος
φιλτάτους	A-	φιλτάτους
φίλτερον	A-	φίλτερος
φλογί	Nb	φλογί
φλογωπὰ	a-p---na-	φλογωπός
φλόγα	n-s---fa-	φλόξ
φλόγα	n-s---ma-	φλόξ
φλογὶ	n-s---md-	φλόξ
φλογὶ	n-s---fd-	φλόξ
φλογί	n-s---fd-	φλώγ
φοβερὰ	a-p---na-	φοβερός
φοβερὰ	a-s---fn-	φοβερός
φοβερὰν	a-s---fa-	φοβερός
φοβούμενον	v-sppema-	φοβέω
φοβούμενος	v-sppemn-	φοβέω
φόβας	n-p---fa-	φόβη
φοβούμεθα	V-	φοβούμεθα
φοβοίμην	v1spoe---	φοβόω
Φοίβου	Ne	φοῖβος
Φοίβου	n-s---mg-	φοῖβος
Φοίβῳ	n-s---md-	φοῖβος
Φοίβῳ	Ne	φοῖβος
Φοινίκας	Nb	Φοινίξ
φοινίῳ	Ne	φοινίος
Φοί	Nb	Φοίς
φόνιος	a-s---mn-	φόν
φονεύειν	V-	φονεύειν
Φονέα	Nb	φονεύς
φονεύς	Nb	φονεύς
φονίᾳ	a-p---na-	φονῖος
φονίαν	a-s---fa-	φονῖος
φονίας	a-s---fg-	φονῖος
φονίας	a-p---fa-	φονῖος
φονίας	n-p---fa-	φονῖος
φονίου	a-s---ng-	φονῖος
φονίου	a-s---mg-	φονῖος
φονίου	n-s---mg-	φονῖος
φονίους	a-p---ma-	φονῖος
φονίῳ	a-s---nd-	φονῖος
φονίων	a-p---ng-	φονῖος
φόνιον	A-	φόνιος
φονίωι	A-	φονίωι
φορβὰν	n-s---ma-	φορβή
Φόρβας	n-p---fa-	Φόρβη
φορούμενοι	v-pppemn-	φορέω
φορούμενος	v-sppemn-	φορέω
φορώτατος	a-s---mns	φορώς
φράζ	V-	φράζ
φράζ	V-	φράζμι
φράζωμεν	V-	φράζωμεν
φράσεις	V-	φράσεις
φρένα	n-s---fa-	φρήν
φρένα	n-s---ma-	φρήν
φρένας	n-p---fa-	φρήν
φρένας	n-p---ma-	φρήν
φρενί	n-s---fd-	φρήν
φρεσίν	n-p---fd-	φρήν
φρεσίν	n-p----d-	φρήν
φρεσὶν	n-p---fd-	φρήν
φροιμιάζηι	V-	φροιμιάζηι
φρονείτω	v3spma---	φρονέω
φρονήσας	v-sapamn-	φρονέω
φρόντιζ’	V-	φρόντιζ’
φρόντιζ’	V-	φρόντιζ’μι
ἐφρούρει	V-	φρουρέω
Φρύγια	Ne	Φρύγια
Φρυγῶν	Nb	Φρυγῶν
Φρυξὶ	Nb	Φρυξὶ
φυγῆς	Nb	φυγῆς
φυλακὰς	Nb	φυλακή
φύλακας	Nb	φύλαξ
φυλάξαι	V-	φυλάσσω
φυλλὰς	Nb	φυλλὰς
φὺς	Nb	φύς
φυσήματι	Nb	φυσήμα
φυσήματα	Nb	φυσήματα
φύσιν	Nb	φύσιν
φωνήσαντος	v-sapamg-	φωνέω
φωνήσασα	v-sapafn-	φωνέω
φωνούντων	v-pppamg-	φωνέω
φωνὰς	n-p---fa-	φωνή
φωτὶ	n-s---md-	φώς
χαίρειν	V-	χαίρω
χαλᾶτε	V-	χαλάω
χαλεποῦ	A-	χαλεπός
χαλεπώτατα	A-	χαλεπώς
χαλκέων	Nb	χαλκεύς
χαλκόπους	Nb	χαλκόπους
χαράσσου	V-	χαράσσου
χάριν	Nb	χάριν
χαρμονᾶι	V-	χαρμονᾶι
χείλεσιν	n-p---nd-	χεῖλος
χείλη	n-p---na-	χεῖλος
κέχυται	v3srie---	χέω
χέασθαι	v--pne---	χέω
χυθέντος	v-sappmg-	χέω
χηλὰς	n-p---fa-	χηλή
χηρεύσηι	V-	χηρεύσηι
χήραν	a-s---fa-	χῆρος
χθονίαν	a-s---fa-	χθονῖος
χθονίας	a-s---fg-	χθονῖος
χθονίοις	a-p---nd-	χθονῖος
χθονίου	a-s---mg-	χθονῖος
Χθονίας	a-p---fa-	Χθονῖος
χθόνα	Nb	χθών
χθόνα	n-s---fa-	χθών
χθονί	n-s---fd-	χθών
χθονὶ	n-s---fd-	χθών
χλοερὰ	a-p---na-	χλοερός
χλόα	Nb	χλόον
χλωρά	a-p---nn-	χλωρός
χλωρὰν	a-s---fa-	χλωρός
χνας	n-p---fa-	χνη
χνόας	n-p---fa-	χνόη
χοάς	n-p---fa-	χοή
χοὰς	Nb	χοή
χοὰς	n-p---fa-	χοή
Χοὰς	n-p---fa-	χοή
χοιράδες	Nb	χοιράδες
χολωθείς	v-sappmn-	χολόω
χορεύσει	Nb	χορεύσει
χοροποί	n-d---mn-	χοροπός
χοροί	n-p---mn-	χορός
χρείας	Nb	χρεία
χρείη	v3spoa---	χρή
χρήσας	v-sapamn-	χρήδω
χρησμοί	n-p---mn-	χρησμός
χρησμούς	n-p---ma-	χρησμός
χρηστά	a-p---na-	χρηστός
χρηστά	a-p---nn-	χρηστός
χρηστὰ	a-p---na-	χρηστός
χρηστὰ	a-p---nn-	χρηστός
χρηστὰς	a-p---fa-	χρηστός
χρηστοί	a-p---mn-	χρηστός
χρήσας	v-sapamn-	χρήω
χρονίζοντ	V-	χρονίζοντ
χρονίαν	a-s---fa-	χρονῖος
χρόνια	A-	χρόνιος
χρόνιοι	A-	χρόνιος
χρόνιον	A-	χρόνιος
Χρύσης	Ne	χρύσης
χρυσοῦ	Nb	χρυσός
χρυσῶι	A-	χρυσῶ
χρόα	Nb	χρώς
χρόα	n-s---ma-	χρώς
χροΐ	n-s---md-	χρώς
χροῒ	n-s---md-	χρώς
χρωτὶ	n-s---md-	χρώς
χώσαντες	v-papamn-	χώζω
χώρας	Nb	χώρα
χωρίσας	V-	χωρίσας
ψακάδι	Nb	ψακάς
ψυχὰς	Nb	ψυχή
ψυχῇ	Nb	ψυχή
ψυχήν	Nb	ψυχή
ψυχῆς	Nb	ψυχή
ψυχορραγοῦντα	V-	ψυχορραγέω
ψύχει	n-s---nd-	ψῦχος
ὤσασθαι	v--anm---	ὠθέω
ὤικτιρ	V-	ὤικτιρ
ὠλένας	n-p---fa-	ὠλένη
ὠμοί	i--------	ὠμος
ὠμὰ	a-p---na-	ὠμός
ὠνούμεθα	v1ppie---	ὠνέω
ὠνόμαξεν	V-	ὠνόμαξεν
ὠνομάσθης	V-	ὠνομάσθης
ὡραίων	A-	ὡραῖος
ὡρίσαντ	V-	ὡρίσαντ
ὡρμήσαμεν	v1paia---	ὡρμήω
ὤταν	G-	ὤταν
ὤτι	x--------	ὤτις
ὠφελούμεθα	v1pfim---	ὠφελέω
ὠφελούμενος	V-	ὠφελούμενος
