lemma	tag	token	macron	source
τλάς	a-s---mn-	ʽτλὰς	ᾱ
τλὰς	a-s---mn-	ʽτλὰς	ᾱ
ἄτᾳ	p-p---na-	ἄ	αᾱ
ἀβλαβείᾳ	n-s---fd-	ἀβλαβεία	ααᾱ
ἀβουλιᾶν	n-s---fa-	ἀβουλιᾶ	αᾱ
ἀβουλίᾳ	n-s---fd-	ἀβουλία	αᾱ
ἀβουλίας	n-s---fg-	ἀβουλία	αᾱ
ἄγ	v2spma---	ἄγ	ᾱ
ἂγ	v2spma---	ἂγ	ᾱ
Ἀγαβάτας	n-s---mn-	Ἀγαβάτας	Αααᾱ
ἀγαθᾶι	a-p---fn-	ἀγαθᾶι	ααᾱ
ἀγαθᾶς	a-p---fa-	ἀγαθᾶς	ααᾱ
ἀγαθάς	a-p---fa-	ἀγαθός	ααᾱ
ἀγαθάς	a-p---fa-	ἀγαθός	ααᾱ
ἀγαθὰς	a-p---fa-	ἀγαθός	ααᾱ
ἀγαθᾶς	a-p---fa-	ἀγαθός	ααᾱ
Ἀγαμεμνονείας	a-s---fg-	Ἀγαμεμνονεῖος	Ααᾱ
Ἀγαμεμνονίαν	n-s---ma-	Ἀγαμεμνονία	Ααᾱ
Ἀγαμεμνονίδας	n-s---fg-	Ἀγαμεμνονίδη	Ααᾱ
ἀγγελίας	n-p---fa-	ἀγγελία	αᾱ
ἀγγελίας	n-s---fg-	ἀγγελία	αᾱ
ἀγγείλας	v-sapamn-	ἀγγέλλω	αᾱ
ἀγείρας	v-sapamn-	ἀγείρω	αᾱ
ἀγελαίας	a-p---fa-	ἀγελαῖος	αᾱ
ἀγέλας	n-p---fa-	ἀγέλη	αᾱ
Ἀγηνοριδᾶν	n-s---ma-	Ἀγηνοριδᾶς	Αᾱ
ἀγκάλας	n-p---fa-	ἀγκάλας	ααᾱ
ἀγκάλας	n-p---fa-	ἀγκάλη	ααᾱ
ἀγκύλας	n-p---fa-	ἀγκύλη	αᾱ
ἀγκύρας	n-p---fa-	ἄγκυρα	αᾱ
ἀγλαΐας	n-s---fg-	ἀγλαία	ααᾱ
ἀγλαάς	a-p---fa-	ἀγλαός	ααᾱ
ἀγλαὰς	a-p---fa-	ἀγλαός	ααᾱ
ἁγνᾷ	a-s---fn-	ἁγνᾷ	αᾱ
ἁγνίσας	v-sapamn-	ἁγνίζω	αᾱ
ἀγνοίᾳ	n-s---fd-	ἄγνοια	αᾱ
ἀγνοίας	n-s---fg-	ἄγνοια	αᾱ
ἁγνάς	a-p---fa-	ἁγνός	αᾱ
ἁγνὰς	a-p---fa-	ἁγνός	αᾱ
ἁγνᾶς	a-s---fg-	ἁγνός	αᾱ
ἀγορᾷ	n-s---fd-	ἀγορά	αᾱ
ἀγορᾶς	n-s---fg-	ἀγορά	αᾱ
ἄγρας	n-s---fg-	ἄγρα	αᾱ
ἄγρας	n-p---fa-	ἄγρα	αᾱ
ἀγρευτάν	n-s---ma-	ἀγρευτάν	αᾱ
ἀγρευτὰν	n-s---ma-	ἀγρευτὰν	αᾱ
ἀγρίας	a-p---fa-	ἄγριος	αᾱ
ἀγρίας	a-s---fg-	ἄγριος	αᾱ
ἀγροβάτας	a-s---mn-	ἀγροβάτας	ααᾱ
ἀγρωστᾶν	a-s---fa-	ἀγρωστᾶν	αᾱ
ἀγρώστας	a-p---fa-	ἀγρώστη	αᾱ
ἀγυιάς	n-p---fa-	ἀγυιά	αᾱ
ἀγυιάς	n-p---fa-	ἀγυιάς	αᾱ
ἀγυιᾶτ’	v2piia---	ἀγυιᾶτ	αᾱ
ἀγυιάς	n-p---fa-	ἀγυιός	αᾱ
ἀγυιὰς	n-p---fa-	ἀγυιός	αᾱ
ἀγχόνας	n-p---fa-	ἀγχόνη	αᾱ
ἀγωνίας	n-p---fa-	ἀγωνία	αᾱ
ἀδελφάν	n-s---ma-	ἀδελφάν	αᾱ
ἀδελφάς	n-p---fa-	ἀδελφή	αᾱ
ἀδελφάς	n-p---fa-	ἀδελφή	αᾱ
ἀδελφὰς	n-p---fa-	ἀδελφή	αᾱ
Ἀΐδαν	n-s---ma-	ᾅδης	Αᾱ
ἀδικίας	n-p---fa-	ἀδικία	αᾱ
ἀδμήτα	n-s---mv-	ἀδμήτης	αᾱ
ἁδονάν	n-s---ma-	ἁδονάς	αᾱ
Ἀδριηνᾶς	a-p---fa-	Ἀδριηνᾶς	Αᾱ
ἆἔα	v2spma---	ἆἔα	ᾱα
ἀειρομένας	v-pppefa-	ἀειρομένας	αᾱ
ἀείρας	v-sapamn-	ἀείρω	αᾱ
ἄρας	n-p---fa-	ἀείρω	αᾱ
ἄρας	v-sapamn-	ἀείρω	αᾱ
Ἀερίας	a-s---fg-	Ἀερῖος	Αᾱ
Ἀερόπας	n-p---fa-	Ἀερόπη	Αᾱ
Ἀζᾶσιν	n-p---md-	Ἀζᾶς	Αᾱ
Ἀθαναίας	a-p---fa-	Ἀθα	Ααᾱ
ἀθανάτας	a-p---fa-	ἀθανάτας	αααᾱ
Ἀθᾶναι	a-p---fn-	Ἀθᾶνος	Αᾱ
Ἀθάνας	n-p---fa-	ἀθῆναι	Ααᾱ
Ἀθήνας	n-p---fa-	ἀθῆναι	Αᾱ
Ἀθήνας	n-s---fg-	ἀθῆναι	Αᾱ
Ἀθηναίας	n-s---fg-	Ἀθηναίη	Αᾱ
Ἀθηναίας	n-p---fa-	Ἀθηναίη	Αᾱ
Ἀθάνας	n-s---fg-	ἀθήνη	Ααᾱ
Ἀθήνας	n-s---fg-	ἀθήνη	Αᾱ
ἀθλήσας	v-sapamn-	ἀθλέω	αᾱ
ἀθλίας	a-s---fg-	ἄθλιος	αᾱ
ἀθρήσας	v-sapamn-	ἀθρέω	αᾱ
ἀθροίσας	v-sapamn-	ἀθροίζω	αᾱ
Αἰακίδα	n-s---mv-	Αἰακίδας	Αᾱ
Αἰακιδᾶν	n-p---mg-	αἰακίδης	Αᾱ
αἴας	n-s---mn-	αἴας	ᾱ
Αἴας	n-s---mn-	αἴας	Ᾱ
Αἴας	n-s---mn-	Αἴας	Ᾱ
Αἰγαίας	n-s---fg-	Αἰγαίη	Ᾱ
αἴγλας	n-p---fa-	αἴγλη	ᾱ
Ἀίδα	n-s---mg-	Ἀίδα	Ᾱ
Ἀίδᾳ	n-s---mg-	Ἀίδᾳ	Ᾱ
Ἀΐδα	n-s---mg-	Ἀΐδα	Αᾱ
Ἀΐδᾳ	n-s---mg-	Ἀΐδᾳ	Αᾱ
Ἅιδᾳ	n-s---mg-	Ἅιδᾳ	Αᾱ
Ἀίδαν	n-s---ma-	Ἀίδαν	Ᾱ
Ἀίδας	n-s---mn-	Ἀίδας	Ᾱ
Ἀΐδᾳ	n-s---mg-	Ἀΐδας	Αᾱ
Ἀΐδας	n-s---mn-	Ἀΐδας	Αᾱ
Ἀΐδας	n-s---mn-	Ἀΐδης	Αᾱ
αἰθερίας	a-s---fg-	αἰθερῖος	ᾱ
αἰθερίας	a-p---fa-	αἰθερῖος	ᾱ
αἰκείας	a-p---fa-	αἰκεῖος	ᾱ
αἰκίας	n-s---fg-	αἰκία	ᾱ
αἱμάξας	v-sapamn-	αἱμάσσω	αᾱ
αἱματηράς	a-p---fa-	αἱματηρός	αᾱ
αἱματηρὰς	a-p---fa-	αἱματηρός	αᾱ
αἱμύλας	a-p---fa-	αἱμύλη	ᾱ
Αἰνέα	n-s---mv-	Αἰνέας	Ᾱ
Αἰνέαν	n-s---ma-	Αἰνέας	Ᾱ
Αἰνέας	n-s---mn-	αἰνείας	Ᾱ
αἰνέσας	v-sapamn-	αἰνέω	ᾱ
Αἰνιᾶνος	a-s---mg-	αἰνιάν	Ᾱ
αἰόλας	n-p---fa-	αἰόλας	ᾱ
αἰόλας	a-p---fa-	αἰόλος	ᾱ
ἀιόνας	n-p---fa-	ἀιόνη	ᾱ
ἀιστώσας	v-sapamn-	ἀιστοέω	ᾱ
αἰσυμνᾶι	v3spia---	αἰσυμνᾶιμι	ᾱ
αἰσχράς	a-p---fa-	αἰσχρός	ᾱ
αἰσχρὰς	a-p---fa-	αἰσχρός	ᾱ
αἰσχύνας	n-p---fa-	αἰσχύνη	ᾱ
αἰσχύνας	v2siia---	αἰσχύνω	ᾱ
αἰτίᾳ	n-s---fd-	αἰτία	ᾱ
αἰτίας	n-s---fg-	αἰτία	ᾱ
αἰτιᾶσθε	v2ppie---	αἰτιάομαι	ᾱ
Αἰτναίας	n-p---fa-	Αἰτναίη	Ᾱ
Αἴτνας	n-p---fa-	Αἴτνη	Ᾱ
Αἰτωλίας	n-s---fg-	Αἰτωλία	Ᾱ
αἰχμαλωτίδας	a-p---fa-	αἰχμαλωτίς	αᾱ
αἰχμαλωτίδας	n-p---fa-	αἰχμαλωτίς	αᾱ
αἰχμάς	n-p---fa-	αἰχμή	ᾱ
αἰχμὰς	n-p---fa-	αἰχμή	ᾱ
ἀκάκας	n-s---mn-	ἀκάκας	ααᾱ
ἀκούσας	v-sapamn-	ἀκέω	αᾱ
ἀκμαίας	a-p---fa-	ἀκμαίη	αᾱ
ἀκμάς	n-p---fa-	ἀκμή	αᾱ
ἀκμάς	n-p---fa-	ἀκμή	αᾱ
ἀκμὰς	n-p---fa-	ἀκμή	αᾱ
ἀκοάς	n-p---fa-	ἀκοή	αᾱ
ἀκοὰς	n-p---fa-	ἀκοή	αᾱ
ἀκοίταν	n-s---ma-	ἀκοίτης	αᾱ
ἀκούσας	v-sapamn-	ἀκούω	αᾱ
Ἀκραίας	a-s---fg-	Ἀκραῖος	Αᾱ
ἀκροτάτας	a-p---fas	ἀκρός	ααᾱ
ἄκρας	n-s---fg-	ἄκρος	αᾱ
ἄκρας	a-p---fa-	ἄκρος	αᾱ
ἄκρας	n-p---fa-	ἄκρος	αᾱ
ἄκρας	a-s---fg-	ἄκρος	αᾱ
ἀκτᾶς	n-p---fa-	ἀκτᾶς	αᾱ
ἀκτάς	n-p---fa-	ἀκτή	αᾱ
ἀκτάς	n-p---fa-	ἀκτή	αᾱ
ἀκτὰς	n-p---fa-	ἀκτή	αᾱ
ἀκτᾶς	n-p---fa-	ἀκτή	αᾱ
ἀκτῖν’	n-s---fa-	ἀκτῖν	ῑ
ἀκτῖνα	n-s---fa-	ἀκτῖνα	ῑ
ἀκτῖνας	n-p---fa-	ἀκτῖνας	ῑ
ἀκτῖνος	n-s---fg-	ἀκτῖνός	ῑ
ἀκτῖσιν	n-p---fd-	ἀκτῖς	ῑι
ἀλλοτρίας	a-s---fg-	ἀλ	αᾱ
ἀλαλᾶι	a-p---fn-	ἀλαλᾶ	ααᾱ
ἀλαλαγάς	n-p---fa-	ἀλαλαγή	αααᾱ
ἀλαλαγὰς	n-p---fa-	ἀλαλαγή	αααᾱ
ἀλᾶσθαι	v--pne---	ἀλᾶμαι	αᾱ
ἀλᾶται	v3spia---	ἀλᾶμαι	αᾱ
ἀλωμένας	v-pppefa-	ἀλάομαι	αᾱ
ἀλᾶτα	d--------	ἀλᾶς	αᾱα
Ἁλάς	n-s---mn-	Ἁλάς	Αᾱ
ἀλάταν	n-s---ma-	ἀλάτας	ααᾱ
ἀλάταν	a-s---ma-	ἀλάτας	ααᾱ
ἀλάτας	n-s---mn-	ἀλάτας	ααᾱ
ἀλάταν	n-s---ma-	ἀλάτης	ααᾱ
ἀλγεινοτάτας	a-s---fgs	ἀλγεινός	ααᾱ
ἀλγήσας	v-sapamn-	ἀλγέω	αᾱ
ἀλγηδόνας	n-p---fa-	ἀλγηδών	αᾱ
ἀλγῦναι	v--ana---	ἀλγῦναί	ῡ
ἀλγύνεικυρήσας	v-sapamn-	ἀλγύνεικυράω	αᾱ
ἀληθείᾳ	n-s---fd-	ἀλήθεια	αᾱ
ἀληθείας	n-s---fg-	ἀλήθεια	αᾱ
ἀλήταν	n-s---ma-	ἀλήταν	αᾱ
ἁλιαδᾶν	n-p---mg-	ἁλιάδης	ααᾱ
ἁλίσας	v-sapamn-	ἁλίζω	αᾱ
ἁλίας	a-p---fa-	ἁλίη	αᾱ
ἁλίας	a-p---fa-	ἁλίος	αᾱ
ἁλούσας	v-papafa-	ἁλίσκομαι	αᾱ
ἀλκᾷ	n-s---fd-	ἀλκά	αᾱ
ἀλκᾶς	n-s---fg-	ἀλκά	αᾱ
ἀλκᾶι	n-s---fd-	ἀλκᾶ	αᾱ
ἀλκᾷ	n-s---fn-	ἀλκᾷ	αᾱ
ἀλκᾶι	u--------	ἀλκᾶι	αᾱ
ἀλκάς	n-s---fg-	ἀλκάς	αᾱ
ἀλκὰς	n-s---fg-	ἀλκὰς	αᾱ
ἀλκᾶς	n-s---fg-	ἀλκᾶς	αᾱ
Ἀλκμήνας	n-s---fg-	ἀλκμήνη	Αᾱ
Ἀλκμήνας	n-p---fa-	ἀλκμήνη	Αᾱ
ἀλλαγᾷ	v1sria---	ἀλλαγᾷ	ααᾱ
ἀλλαγᾷ	d--------	ἀλλαγᾷ	ααᾱ
ἀλλάξας	v-sapamn-	ἀλλάσσω	ααᾱ
ἀλλήλας	a-p---fa-	ἀλλήλας	αᾱ
ἀλλήλας	a-p---fa-	ἀλλήλων	αᾱ
ἄλλᾳ	a-p---na-	ἄλλος	αᾱ
ἄλλας	a-p---fa-	ἄλλος	αᾱ
ἀλλοτρίας	a-s---fg-	ἀλλότριος	αᾱ
ἅλμας	n-s---fg-	ἅλμας	αᾱ
ἁλμυρᾶς	a-s---fg-	ἁλμυρός	αᾱ
ἀλουσίας	n-p---fa-	ἀλουσίη	αᾱ
ἀλφηστᾶν	a-s---fa-	ἀλφηστᾶν	αᾱ
Ἀμαζόνας	n-p---fa-	ἀμαζών	Ααᾱ
ἀμαθίας	n-s---fg-	ἀμαθία	ααᾱ
ἀμαθίας	n-p---fa-	ἀμαθία	ααᾱ
ἀμαιμακετᾶν	a-s---fa-	ἀμαιμακετᾶς	ααᾱ
ἀμᾶν	n-s---na-	ἀμᾶν	αᾱ
ἁμαρτίας	n-p---fa-	ἁμαρτία	ααᾱ
ἁμαρτίας	n-s---fg-	ἁμαρτία	ααᾱ
ἀμαυρᾶς	n-s---fg-	ἀμαυρᾶς	αᾱ
ἀμαυρᾶς	a-s---fg-	ἀμαυρᾶς	αᾱ
ἀμαυρᾶς	n-s---fg-	ἀμαυρή	αᾱ
ἀμᾷ	v3spia---	ἀμάω	αᾱ
ἀμβάς	n-p---fa-	ἀμβή	αᾱ
ἀμβὰς	n-p---fa-	ἀμβή	αᾱ
ἀμβολάς	n-p---fa-	ἀμβολή	αᾱ
ἀμβολὰς	n-p---fa-	ἀμβολή	αᾱ
ἀμείψας	v-sapamn-	ἀμείβω	αᾱ
ἁμέρᾳ	n-s---fn-	ἁμέρᾳ	αᾱ
Ἁμέρας	a-s---fg-	Ἁμέρας	Αᾱ
ἀμέρσας	v-sapamn-	ἀμέρζω	αᾱ
ἁμέρα	n-d---fn-	ἁμέρη	αᾱ
ἁμέρας	n-s---fg-	ἁμέρη	αᾱ
ἁμετέρας	a-s---fg-	ἁμέτερος	αᾱ
ἀμηχανίας	n-s---fg-	ἀμηχανία	ααᾱ
ἁμίλλας	n-s---mn-	ἁμίλ	αᾱ
ἁμιλλᾶι	n-p---fn-	ἁμιλλᾶ	αᾱ
ἁμίλλας	n-p---fa-	ἁμίλλα	αᾱ
ἁμίλλας	n-s---fg-	ἁμίλλα	αᾱ
ἁμιλλᾶσθαι	v--pne---	ἁμιλλάομαι	αᾱ
ἁμιλλᾶται	v3spie---	ἁμιλλάω	αᾱ
Ἀμμωνιάδας	n-p---fa-	Ἀμμωνιάδη	Ααᾱ
ἀμοιβάς	n-p---fa-	ἀμοιβή	αᾱ
ἀμοιβὰς	n-p---fa-	ἀμοιβή	αᾱ
ἀμουσίας	n-p---fa-	ἀμουσίη	αᾱ
ἀμπείρας	n-p---fa-	ἀμπείρη	αᾱ
ἀμπετάσας	v-sapamn-	ἀμπετάζω	ααᾱ
ἀμπετάσας	v-sapamn-	ἀμπετάω	ααᾱ
ἀμπλακίας	n-s---fg-	ἀμπλακεία	ααᾱ
ἀμπνοάς	a-s---mn-	ἀμπνοάς	αᾱ
ἀμπνοάς	n-p---fa-	ἀμπνοάς	αᾱ
ἀμπνοὰς	a-s---mn-	ἀμπνοὰς	αᾱ
ἀμῦναι	v--ana---	ἀμύνω	ῡ
Ἀμφαναίας	a-p---fa-	Ἀμφαναί	Ααᾱ
ἀμφεστᾶσι	v3ppia---	ἀμφεστᾶσι	αᾱ
ἀμφιβᾶσα	v-sapafn-	ἀμφιβαίνω	αᾱα
ἀμφιβᾶσ’	v-sapafn-	ἀμφιβᾶσ	αᾱ
Ἀμφιονίας	a-s---fg-	Ἀμφιονῖος	Αᾱ
ἀμφιπτυχάς	v-sapamn-	ἀμφιπτυχά	αᾱ
Ἀμφιτρίτας	n-s---fg-	Ἀμφιτρί	Αᾱ
Ἀμφιτρίτας	n-s---fg-	Ἀμφιτρίτη	Αᾱ
ἀμφοτέρας	a-p---fa-	ἀμφότερος	αᾱ
ἀμφυγᾶς	v2sria---	ἀμφυγᾶς	αᾱ
ἀναβᾶσ’	v-sapafn-	ἀναβᾶσ	ααᾱ
ἀναβοᾶι	v2spie---	ἀναβοᾶι	ααᾱ
ἀναβοάσας	v-sapamn-	ἀναβοάσας	αααᾱ
ἀναγκάσας	v-sapamn-	ἀναγκάζω	αααᾱ
ἀναγκαίας	a-s---fg-	ἀναγκαῖος	ααᾱ
ἀναγκαίας	a-p---fa-	ἀναγκαῖος	ααᾱ
ἀνάγκας	n-p---fa-	ἀνάγκας	ααᾱ
ἀνάγκας	n-p---fa-	ἀνάγκη	ααᾱ
Ἀνάγκας	n-p---fa-	ἀνάγκη	Ααᾱ
ἀναδεσμᾶν	n-s---na-	ἀναδεσμᾶις	ααᾱ
ἀναιδείας	n-s---fg-	ἀναιδεία	αᾱ
ἀναιδείας	n-p---fa-	ἀναιδείη	αᾱ
ἀνακλάσας	v-sapamn-	ἀνακλάω	αααᾱ
ἀναλώσας	v-sapamn-	ἀναλώζω	ααᾱ
ἀνανδρίας	n-s---fg-	ἀνανδρία	ααᾱ
ἄνα	n-s---mv-	ἄναξ	αᾱ
ἀναπτύξας	v-sapamn-	ἀναπτύσσω	ααᾱ
ἀναρπάσας	v-sapamn-	ἀναρπάζω	αααᾱ
ἀναρπάσας	v-sapamn-	ἀναρπάω	αααᾱ
Ἀναρχίας	n-s---fg-	Ἀναρχία	Ααᾱ
ἀνᾴσσων	v-sppamn-	ἀνᾴσσω	αᾱ
ἀναστᾶσ’	v-sapafn-	ἀναστᾶσ	ααᾱ
ἀναστρέψας	v-sapamn-	ἀναστρέπω	ααᾱ
ἀνατλάς	v-sapamn-	ἀνατλάς	ααᾱ
ἀνατλὰς	v-sapamn-	ἀνατλὰς	ααᾱ
ἀνατλᾶσα	v-sapafn-	ἀνατλᾶσα	ααᾱα
ἀνατροπάς	n-p---fa-	ἀνατροπή	ααᾱ
ἀναψυχάς	a-p---fa-	ἀναψυχάς	ααᾱ
ἀναψυχὰς	a-p---fa-	ἀναψυχὰς	ααᾱ
ἀναψυχάς	n-p---fa-	ἀναψυχή	ααᾱ
ἀνδρείᾳ	n-s---fd-	ἀνδρεία	αᾱ
ἀνδρείας	n-s---fg-	ἀνδρεία	αᾱ
ἀνεβόα	v3siia---	ἀνεβόας	αᾱ
ἀνεωιγμένας	v-prpefa-	ἀνεωιγμένας	αᾱ
ἀνηβᾶι	a-p---fn-	ἀνηβᾶς	αᾱ
ἀνθήσας	v-sapamn-	ἀνθάω	αᾱ
ἀνίας	n-p---fa-	ἀνία	αᾱ
ἀνιᾷ	v3siia---	ἀνιάω	αᾱ
ἀνιᾷς	v2spia---	ἀνιάω	αᾱ
ἀνιᾶσθαι	v--pne---	ἀνιάω	αᾱ
ἀνειμένας	v-prpefa-	ἀνίημι	αᾱ
ἁνίκα	v3siia---	ἁνικάω	αᾱ
ἀναστάς	v-sapamn-	ἀνίστημι	ααᾱ
ἀναστὰς	v-sapamn-	ἀνίστημι	ααᾱ
ἀνοίας	n-s---fg-	ἄνοια	αᾱ
ἀνοίξας	v-sapamn-	ἀνοίγνυμι	αᾱ
ἀνοσιωτάτας	a-p---fa-	ἀνοσιωτάτας	ααᾱ
ἀντᾶραι	v2spie---	ἀντᾶρω	αᾱ
ἀνταυδᾷς	v2spia---	ἀνταυδάω	αᾱ
ἀντήσας	v-sapamn-	ἀντάω	αᾱ
ἀντερᾶις	n-p---fd-	ἀντερᾶις	αᾱ
ἀντήσας	v-sapamn-	ἀντέω	αᾱ
ἀντηρέτας	v3siie---	ἀντηρέτας	αᾱ
ἀντηρέτας	n-p---fa-	ἀντηρέτη	αᾱ
ἀντιάσας	v-sapamn-	ἀντιάω	ααᾱ
ἀντιβᾶσα	v-sapafn-	ἀντιβαίνω	αᾱα
ἀντιδρᾶν	v--pna---	ἀντιδρᾶν	αᾱ
ἀντιδρᾶν	v--pna---	ἀντιδράω	αᾱ
ἀντίας	a-p---fa-	ἀντίος	αᾱ
ἀντισηκώσας	v-sapamn-	ἀντισηκώζω	αᾱ
ἀντιστάς	v-sapamn-	ἀντισταίνω	αᾱ
ἀντιστὰς	v-sapamn-	ἀντισταίνω	αᾱ
Ἀντιτύπᾳ	a-s---fd-	ἀντίτυπος	Αᾱ
ἀντολάς	n-p---fa-	ἀντολή	αᾱ
ἀντολάς	n-p---fa-	ἀντολή	αᾱ
ἀντολὰς	n-p---fa-	ἀντολή	αᾱ
ᾄξασα	v-sapafn-	ᾄξασα	ᾱαα
ᾄξας	n-p---fa-	ᾄξη	ᾱᾱ
ἀξίνας	n-p---fa-	ἀξίνη	αᾱ
ἀξίας	a-s---fg-	ἄξιος	αᾱ
ἀξιώσας	v-sapamn-	ἀξιόω	αᾱ
ἄξας	v-sapamn-	ἄξω	αᾱ
ἆὀδύνη	u--------	ἆὀδύνη	ᾱ
ἀοιδάς	n-p---fa-	ἀοιδάς	αᾱ
ἀοιδάς	n-p---fa-	ἀοιδή	αᾱ
ἀοιδάς	n-p---fa-	ἀοιδή	αᾱ
ἀοιδὰς	n-p---fa-	ἀοιδή	αᾱ
ᾠδάς	n-p---fa-	ἀοιδή	ᾱ
ᾠδὰς	n-p---fa-	ἀοιδή	ᾱ
ἀπαιδίας	n-s---fg-	ἀπαιδία	αᾱ
ἀπήνας	v-sapamn-	ἀπαίνω	αᾱ
ἀπαιολᾶι	v3spia---	ἀπαιολᾶι	αᾱ
ἀπάρας	v-sapamn-	ἀπαίρω	ααᾱ
ἀπαλλαγάς	n-p---fa-	ἀπαλλαγή	αααᾱ
ἀπαλλαγάς	n-p---fa-	ἀπαλλαγή	αααᾱ
ἀπαλλαγὰς	n-p---fa-	ἀπαλλαγή	αααᾱ
ἀπαλλάξας	v-sapamn-	ἀπαλλάσσω	αααᾱ
ἀπαντᾶι	v2spie---	ἀπαμᾶι	ααᾱ
ἀπαντᾶν	v--pna---	ἀπαντάω	ααᾱ
ἀπαντᾶν	a-s---ma-	ἀπαντάω	ααᾱ
ἀπαντήσας	v-sapamn-	ἀπαντήω	ααᾱ
ἀπᾴξας	v-sapamn-	ἀπᾴξας	αᾱᾱ
ἀπαρχάς	n-p---fa-	ἀπαρχή	ααᾱ
ἀπαρχὰς	n-p---fa-	ἀπαρχή	ααᾱ
ἅπας	a-s---mn-	ἅπας	αᾱ
Ἅπας	a-s---mn-	ἅπας	Αᾱ
ἁπάσας	a-p---fa-	ἅπας	ααᾱ
ἀπάτας	n-p---fa-	ἀπάτη	ααᾱ
ἀπαυδᾶις	v2spia---	ἀπαυδᾶις	αᾱ
ἀπαυδᾶν	v--pna---	ἀπαυδάω	αᾱ
ἀπηύδα	v3siia---	ἀπαυδάω	αᾱ
ἀπηύρα	v3siia---	ἀπαυράω	αᾱ
ἀπούσας	v-pppafa-	ἀπάω	αᾱ
ἀπειθήσας	v-sapamn-	ἀπειθέω	αᾱ
ἀπειλάς	n-p---fa-	ἀπειλή	αᾱ
ἀπειλάς	n-p---fa-	ἀπειλή	αᾱ
ἀπειλὰς	n-p---fa-	ἀπειλή	αᾱ
ἀπεμπολᾶις	n-p---fd-	ἀπεμπολᾶις	αᾱ
ἀπεμπολᾶτε	v2pama---	ἀπεμπολᾶτε	αᾱ
ἀπεχθείας	n-s---fg-	ἀπεχθεία	αᾱ
ἀπημπόλα	v3siia---	ἀπημπόλα	αᾱ
ἀπήνας	v-sapamn-	ἀπήνη	αᾱ
Ἀπίας	a-s---mn-	ἄπιος	Αᾱ
Ἀπίας	a-s---fg-	ἄπιος	Αᾱ
ἀπιστίας	n-s---fg-	ἀπιστία	αᾱ
ἁπλᾶς	a-p---fa-	ἁπλᾶς	αᾱ
ἀπλοίᾳ	a-p---na-	ἀπλοίᾳ	αᾱ
ἀπλοίας	a-p---fa-	ἀπλοίας	αᾱ
ἀποζυγείσας	v-pppafa-	ἀπό	αᾱ
ἀποβάς	v-sapamn-	ἀποβαίνω	αᾱ
ἀποβλέψας	v-sapamn-	ἀποβλέπω	αᾱ
ἀποινᾶσθαι	v--anm---	ἀποινᾶσθαι	αᾱ
ἀποστᾶσα	v-sapafn-	ἀποίστημι	αᾱα
ἀποιχομένας	v-pppefa-	ἀποιχομένας	αᾱ
ἀποκλῖναι	v--ana---	ἀποκλῖναι	ῑ
ἀποκρίνας	v-sapamn-	ἀποκρίνω	αᾱ
ἀποκρύψας	v-sapamn-	ἀποκρύπτω	αᾱ
ἀποκτείνας	v-sapamn-	ἀποκτείνω	αᾱ
ἀποκωκῦσαι	v--ana---	ἀποκωκῦζω	ῡ
ἀπολέσας	v-sapamn-	ἀπόλλυμι	αᾱ
ἀπόλλυσιν	v3spia---	ἀπόλλυμι	ῡ
ἀποπεμψαμένα	v-dapmfn-	ἀποπεμψαμένα	ααᾱ
ἀπορίας	n-s---fg-	ἀπορία	αᾱ
ἀποσπάσας	v-sapamn-	ἀποσπάζω	ααᾱ
Ἀποσπάσας	v-sapamn-	Ἀποσπάω	Ααᾱ
ἀποστᾶσ’	v-sapafn-	ἀποστᾶσ	αᾱ
ἀποσυλᾶται	v3spie---	ἀποσυλάομαι	αᾱ
ἀποσυλήσας	v-sapamn-	ἀποσυλέω	αᾱ
ἀπουσίᾳ	n-s---fd-	ἀπουσία	αᾱ
ἀπουσίας	n-s---fg-	ἀπουσία	αᾱ
ἀπουσίας	n-s---fg-	ἀπουσίας	αᾱ
ἀποφθείρας	v-sapamn-	ἀποφθείρω	αᾱ
ἀποφθορᾷ	a-p---na-	ἀποφθορᾷ	αᾱ
ἀράς	n-p---fa-	ἀρά	αᾱ
ἀράς	v-sapamn-	ἀρά	αᾱ
ἀράς	n-p---fa-	ἀρά	αᾱ
Ἀράς	n-p---fa-	ἀρά	Αᾱ
Ἀράς	n-p---fa-	ἀρά	Αᾱ
ἀρὰς	n-p---fa-	ἀρά	αᾱ
ἀρὰς	v-sapamn-	ἀρά	αᾱ
Ἀρὰς	n-p---fa-	ἀρά	Αᾱ
ἀρᾶς	n-s---fg-	ἀρά	αᾱ
ἀρᾶς	n-p---fa-	ἀρά	αᾱ
ἀρᾷ	g--------	ἀρᾷ	αᾱ
τἄρα	v2spma---	ἄρα	αᾱ
Ἀραβίας	n-s---fg-	Ἀραβία	Ααᾱ
ἀρᾶι	v3ppia---	ἀρᾶι	αᾱ
ἀρᾶν	n-p---fg-	ἀρᾶν	αᾱ
ἀρᾶται	v3srie---	ἀράομαι	αᾱ
ἀρᾶται	v3sase---	ἀράομαι	αᾱ
ἀράς	n-p---fa-	ἀράς	αᾱ
ἀράξας	v-sapamn-	ἀράσσω	ααᾱ
ἀρβύλας	n-s---fg-	ἀρβύλα	αᾱ
ἀργᾶς	a-p---fa-	ἀργᾶς	αᾱ
Ἀργείας	a-s---fg-	Ἀργείας	Αᾱ
Ἀργείας	a-s---fg-	Ἀργεῖος	Αᾱ
Ἀργείας	a-p---fa-	Ἀργεῖος	Αᾱ
Ἀργείᾳ	a-s---fd-	̓ἀργεῖος	Αᾱ
ἀργίας	n-s---fg-	ἀργία	αᾱ
Ἀργόλας	a-s---mn-	Ἀργόλας	Αᾱ
Ἀρεθούσας	v-pppafa-	Ἀρεθούσας	Αᾱ
Ἀρείας	a-p---fa-	Ἀρείη	Αᾱ
ἀρετᾶι	n-p---fd-	ἀρετᾶι	αᾱ
ἀρετάς	n-p---fa-	ἀρετή	αᾱ
ἀρετὰς	n-p---fa-	ἀρετή	αᾱ
ἀρετᾶς	n-p---fa-	ἀρετή	αᾱ
ἀρετᾶς	n-s---fg-	ἀρετή	αᾱ
Ἀρετᾶς	n-s---fg-	ἀρετή	Αᾱ
ἀριστείας	n-s---fg-	ἀριστεία	αᾱ
ἀριστερᾶς	a-s---fg-	ἀριστερᾶ	αᾱ
ἀριστερᾶς	n-s---fg-	ἀριστερᾶ	αᾱ
ἀριστερᾶς	a-s---fg-	ἀριστερός	αᾱ
ἀριστεύσας	v-sapamn-	ἀριστεύω	αᾱ
ἀρίστας	a-p---fa-	ἄριστος	αᾱ
Ἀρκάς	n-s---mn-	ἀρκάς	Αᾱ
Ἀρκὰς	n-s---mn-	ἀρκάς	Αᾱ
Ἀρκάς	n-s---mn-	Ἀρκάς	Αᾱ
Ἀρκάς	n-p---fa-	Ἀρκάς	Αᾱ
ἀρκέσας	v-sapamn-	ἀρκέω	αᾱ
ἁρματεύσας	v-sapamn-	ἁρματεύσας	ααᾱ
ἁρμόσας	v-sapamn-	ἁρμόζω	αᾱ
Ἁρμονίας	n-s---fg-	Ἁρμονία	Αᾱ
Ἁρμονίᾳ	n-s---fn-	Ἁρμονίᾳ	Αᾱ
ἄρα	n-s---fg-	ἄρος	αᾱ
ἀρούρας	n-p---fa-	ἄρουρα	αᾱ
ἁρπαγάς	n-p---fa-	ἁρπαγή	ααᾱ
ἁρπαγάς	n-p---fa-	ἁρπαγή	ααᾱ
ἁρπαγὰς	n-p---fa-	ἁρπαγή	ααᾱ
ἁρπάσας	v-sapamn-	ἁρπάζω	ααᾱ
ἀρτάνας	n-p---fa-	ἀρτάνη	ααᾱ
ἀρτήσας	v-sapamn-	ἀρτάω	αᾱ
ἀρτηρίας	n-s---fg-	ἀρτηρία	αᾱ
ἀρτίας	a-p---fa-	ἀρτῖος	αᾱ
ἀρχαίας	a-s---fg-	ἀρχαῖος	αᾱ
ἀρχαίας	a-p---fa-	ἀρχαῖος	αᾱ
ἀρχᾶς	n-p---fa-	ἀρχᾶς	αᾱ
ἀρχέταν	n-s---ma-	ἀρχέτης	αᾱ
ἀρχέτας	n-s---mn-	ἀρχέτης	αᾱ
ἀρχάν	n-s---ma-	ἀρχή	αᾱ
ἀρχάς	n-p---fa-	ἀρχή	αᾱ
ἀρχάς	n-p---fa-	ἀρχή	αᾱ
ἀρχὰς	n-p---fa-	ἀρχή	αᾱ
ἀρχᾶς	n-p---fa-	ἀρχή	αᾱ
ἄρξας	v-sapamn-	ἄρχω	αᾱ
ἀρωγάν	v3siia---	ἀρωγάν	αᾱ
ἀρωγάς	n-p---fa-	ἀρωγή	αᾱ
ἀρωγὰς	n-p---fa-	ἀρωγή	αᾱ
Ἀσίας	n-s---fg-	ἀσία	Αᾱ
ἆσίγα	u--------	ἆσίγα	ᾱα
Ἀσιητᾶν	a-s---fa-	Ἀσιητᾶν	Αᾱ
ἀσκήσας	v-sapamn-	ἀσκέω	αᾱ
ἀσμένας	a-p---fa-	ἀσμένας	αᾱ
ἀσπίδας	n-p---fa-	ἀσπίς	αᾱ
ἀσπιστάς	a-p---fa-	ἀσπιστός	αᾱ
ἀσπιστὰς	a-p---fa-	ἀσπιστός	αᾱ
ἀστραβιζούσας	v-pppafa-	ἀστραβιζούσας	ααᾱ
ἀστραπᾶν	n-s---fa-	ἀστραπᾶ	ααᾱ
ἀστραπάς	n-p---fa-	ἀστραπή	ααᾱ
ἀστυγειτονουμένας	v-pppefa-	ἀστυγειτονόομαι	αᾱ
ἀσυλίᾳ	n-s---fd-	ἀσυλία	αᾱ
ἀσυνεσίας	n-p---fa-	ἀσυνεσίη	αᾱ
ἁσυχαίᾳ	n-s---fd-	ἁσυχαία	αᾱ
ἀσφάδᾳστος	a-s---mn-	ἀσφάδᾳστος	ααᾱ
ἀσφαλείᾳ	n-s---fd-	ἀσφάλεια	ααᾱ
ἀσχαλᾶν	v--pna---	ἀσχαλᾶν	ααᾱ
Ἀσωπίας	n-s---fg-	Ἀσωπία	Αᾱ
ἄτᾳ	n-s---fa-	ἄτᾳ	αᾱ
ἀταλᾶς	a-s---fn-	ἀταλᾶς	ααᾱ
ἄτας	n-p---fa-	ἄτας	αᾱ
ἀτᾷ	v3spia---	ἀτάω	αᾱ
ἀτᾶν	n-s---fa-	ἀτάω	αᾱ
ἄτᾳ	n-s---fa-	ἄτη	αᾱ
ἄτᾳ	n-s---fd-	ἄτη	αᾱ
ἄτας	n-s---fg-	ἄτη	αᾱ
ἄτας	n-p---fa-	ἄτη	αᾱ
Ἄτας	n-s---fg-	ἄτη	Αᾱ
ἀτηρᾷ	a-p---na-	ἀτηρός	αᾱ
ἀτηρᾶς	a-s---fg-	ἀτηρός	αᾱ
ἀτηρᾶς	a-p---fa-	ἀτηρός	αᾱ
Ἀτθίδας	n-p---fa-	Ἀτθίς	Αᾱ
ἀτιμάσας	v-sapamn-	ἀτιμάζω	ααᾱ
ἀτιμάσας	v-sapamn-	ἀτιμάσας	ααᾱ
ἀτιμίᾳ	n-s---fd-	ἀτιμία	αᾱ
ἀτιμίας	n-s---fg-	ἀτιμία	αᾱ
Ἀτιμίας	n-s---fg-	ἀτιμία	Αᾱ
ἀτίτας	n-p---fa-	ἀτίτη	αᾱ
Ἄτλας	n-p---fa-	ἄτλας	Αᾱ
Ἄτλας	n-s---mn-	ἄτλας	Αᾱ
Ἀτρειδᾶν	n-p---mg-	̓ἀτρείδης	Αᾱ
αὐγάς	n-p---fa-	αὐγή	ᾱ
αὐγάς	n-p---fa-	αὐγή	ᾱ
αὐγὰς	n-p---fa-	αὐγή	ᾱ
αὐδά	v2spma---	αὐδά	ᾱ
αὔδα	v2spma---	αὔδα	ᾱ
αὔδα	v2spma---	αὐδάω	ᾱ
Αὔδα	v2spma---	αὐδάω	Ᾱ
ηὔδα	v3siia---	αὐδάω	ᾱ
ηὔδας	v2siia---	αὐδάω	ᾱ
Ηὐδᾶτο	v3siie---	αὐδάω	Ᾱ
αὐδάν	n-s---ma-	αὐδή	ᾱ
αὐδὰν	n-s---ma-	αὐδή	ᾱ
αὐθαδίᾳ	n-s---fd-	αὐθαδία	αᾱ
αὐθαδίας	n-s---fg-	αὐθαδία	αᾱ
αὐλάς	n-p---fa-	αὐλή	ᾱ
αὐλὰς	n-p---fa-	αὐλή	ᾱ
αὔρας	n-s---fg-	αὔρη	ᾱ
ἀυτᾶς	u--------	ἀυτᾶς	ᾱ
αὑτᾶςἔτλας	a-p---fa-	αὑτᾶςἔτλας	ᾱα
αὐτάς	a-p---fa-	αὐτός	ᾱ
αὐτάς	a-p---fa-	αὐτός	ᾱ
αὐτὰς	a-p---fa-	αὐτός	ᾱ
ἀΰσας	v-sapamn-	αὔω	αᾱ
Ἀφαίας	n-p---fa-	Ἀφαίη	Αᾱ
Ἀφαίας	a-s---fg-	Ἀφαίη	Αᾱ
ἀφιᾶσιν	v3ppia---	ἀφιᾶμι	αᾱ
ἀφιᾶσ’	v3ppia---	ἀφιᾶσ	αᾱ
ἀφῖγμαι	v1spie---	ἀφῖγμαι	ῑ
ἀφῖγμαι	v1srie---	ἀφῖγμαι	ῑ
ἀφῖξαι	v--ana---	ἀφῖγω	ῑ
ἀφῖκται	v3srie---	ἀφικνέομαι	ῑ
ἀφῖχθαι	v--rne---	ἀφικνέομαι	ῑ
ἀφῖκτο	v3saim---	ἀφῖκτο	ῑ
ἀφῖξαι	v--ana---	ἀφῖσσω	ῑ
ἀποστάς	v-sapamn-	ἀφίστημι	αᾱ
ἀποστὰς	v-sapamn-	ἀφίστημι	αᾱ
ἀφῖξαι	v2samm---	ἀφῖχομαι	ῑ
ἀφορμᾷ	v3spia---	ἀφορμάζω	αᾱ
ἀφορμᾷς	v2spia---	ἀφορμάω	αᾱ
ἀφορμᾶσθαι	v--pne---	ἀφορμάω	αᾱ
ἀφορμάς	n-p---fa-	ἀφορμή	αᾱ
ἀφορμάς	n-p---fa-	ἀφορμή	αᾱ
ἀφορμὰς	n-p---fa-	ἀφορμή	αᾱ
Ἀφροδίτας	n-p---fa-	Ἀφροδί	Αᾱ
Ἀφροδίτας	n-s---fg-	Ἀφροδί	Αᾱ
Ἀφροδίτας	n-p---fa-	Ἀφροδίτη	Αᾱ
Ἀφροδίτας	n-s---fg-	Ἀφροδίτη	Αᾱ
ἀφροσύνας	n-p---fa-	ἀφροσύνα	αᾱ
ἀφροσύνας	n-s---fg-	ἀφροσύνα	αᾱ
ἀφροσύνας	n-p---fa-	ἀφροσύνη	αᾱ
ἀχά	a-d---mn-	ἀχά	αᾱ
Ἀχαιικάς	a-p---fa-	Ἀχαιικός	Αᾱ
Ἀχαιικὰς	a-p---fa-	Ἀχαιικός	Αᾱ
ἀχάν	a-s---ma-	ἀχάν	αᾱ
ἀχὰν	a-s---ma-	ἀχὰν	αᾱ
ἀχέτας	n-s---mn-	ἀχέτης	αᾱ
Ἀχιλείας	n-s---fg-	Ἀχίλεια	Αᾱ
ἀχλαινίας	a-s---fg-	ἀχλαίνιος	αᾱ
ἁψῖδα	n-s---fa-	ἁψῖδα	ῑ
ἀψυχίᾳ	n-s---fn-	ἀψυχία	αᾱ
ἀψυχίᾳ	n-s---fd-	ἀψυχία	αᾱ
ἀψυχίας	n-s---fg-	ἀψυχία	αᾱ
βαθειᾶν	a-p---fg-	βαθειᾶν	αᾱ
βαθρείας	n-s---fg-	βαθρεία	αᾱ
βαθρείας	n-s---fg-	βαθρεῖα	αᾱ
βαθείᾳ	a-s---fd-	βαθύς	αᾱ
βαθείας	a-s---fg-	βαθύς	αᾱ
βαιάν	v2spma---	βαιάν	ᾱ
βάς	v-sapamn-	βαίνω	ᾱ
βὰς	v-sapamn-	βαίνω	ᾱ
ἔβα	v3siia---	βαίνω	ᾱ
βακχᾶν	u--------	βακχᾶν	αᾱ
βακχᾶν	n-s---ma-	βακχᾶς	αᾱ
Βακχᾶν	n-s---fa-	Βακχᾶς	Αᾱ
βακχᾷ	d--------	βακχᾷς	αᾱ
βάκχας	n-s---mn-	βάκχας	αᾱ
βακχείας	n-s---fg-	βακχείη	αᾱ
βακχείας	n-p---fa-	βακχεῖος	αᾱ
βακχίας	a-s---fg-	βάκχειος	αᾱ
Βακχίας	a-s---fg-	βάκχειος	Αᾱ
βακχεύσας	v-sapamn-	βακχεύω	αᾱ
βάκχας	n-p---fa-	βάκχη	αᾱ
Βακχιώτας	n-s---fg-	Βακχιώ	Αᾱ
βαλβῖδα	n-s---fa-	βαλβίς	ῑ
βαλιάν	n-s---ma-	βαλιὰς	αᾱ
βαλιὰν	n-s---ma-	βαλιὰς	αᾱ
βαρυποτμωτάτας	a-s---fgs	βαρυποτμωτάτας	ααᾱ
βαρείᾳ	a-s---fd-	βαρύς	αᾱ
βαρείας	a-p---fa-	βαρύς	αᾱ
βαρείας	a-s---fg-	βαρύς	αᾱ
βάς	v-sapamn-	βάς	ᾱ
βασιλείας	n-s---fg-	βασιλεία	αᾱ
βαφάς	n-p---fa-	βαφή	αᾱ
βαφάς	n-p---fa-	βαφή	αᾱ
βαφὰς	n-p---fa-	βαφή	αᾱ
βεβώσας	v-prpafa-	βεβόω	ᾱ
βεβρωμένας	v-prpefa-	βεβρωμένας	ᾱ
βίᾳ	n-s---fd-	βία	ᾱ
βίας	n-s---fg-	βία	ᾱ
βίᾳ	u--------	βίᾳ	ᾱ
βιαίας	a-s---fg-	βίαιος	ᾱ
βιᾶται	v3spie---	βιάω	ᾱ
βιοτᾶς	n-s---fg-	βιοτᾶ	ᾱ
βιοτᾶι	n-p---mn-	βιοτᾶι	ᾱ
βιοτᾶς	n-p---fa-	βιοτᾶς	ᾱ
βλάβας	n-p---fa-	βλάβη	αᾱ
βλάστας	n-p---fa-	βλάστη	αᾱ
βλέψας	v-sapamn-	βλέπω	ᾱ
βόα	v2spma---	βόα	ᾱ
βοάς	n-p---fa-	βοή	ᾱ
βοηδρομήσας	v-sapamn-	βοηδρομέω	ᾱ
βολάς	n-p---fa-	βολή	ᾱ
βολάς	n-p---fa-	βολή	ᾱ
βολὰς	n-p---fa-	βολή	ᾱ
βοράν	n-s---ma-	βορά	ᾱ
βορέα	n-s---mg-	βορέας	ᾱ
βοσκάς	n-p---fa-	βοσκή	ᾱ
βοσκὰς	n-p---fa-	βοσκή	ᾱ
βουλεύσας	v-sapamn-	βουλεύω	ᾱ
βουλάς	n-p---fa-	βουλή	ᾱ
βουλὰς	n-p---fa-	βουλή	ᾱ
βούταν	n-s---ma-	βούτας	ᾱ
βούτας	n-s---mn-	βούτας	ᾱ
βούταν	n-s---ma-	βούτης	ᾱ
βραβείας	n-p---fa-	βράβεια	αᾱ
Βραυρωνίας	a-p---fa-	Βραυρωνῖος	Ᾱ
βραχείας	a-s---fg-	βραχύς	αᾱ
βρέτας	n-p---fa-	βρές	ᾱ
βρέτας	n-p---fa-	βρέται	ᾱ
βρέτας	n-p---fa-	βρέτη	ᾱ
βρέτας	n-p---fa-	βρέτης	ᾱ
βρίσας	v-sapamn-	βρίζω	ᾱ
βροτείας	n-s---fg-	βροτεία	ᾱ
βροτείας	n-p---fa-	βροτείη	ᾱ
βφρονωγάρ	v2spma---	βφρονωγάρ	ᾱ
γαίας	n-s---fg-	γαῖα	ᾱ
γαίας	n-s---fg-	γαίας	ᾱ
γᾶκαπφθίμενον	v-sapmma-	γᾶκαπφθίω	ᾱα
γαλακτοπότας	n-s---mn-	γαλακτοπότας	ααᾱ
γαλανείας	n-p---fa-	γαλανεία	ααᾱ
γαλάνας	a-p---fa-	γαλάνη	ααᾱ
γαμετᾶν	n-s---fa-	γαμετᾶν	αᾱ
γαμετᾶν	n-s---ma-	γαμετᾶν	αᾱ
γαμέτᾳ	n-s---fd-	γαμέτᾳς	αᾱ
γαμέτας	n-s---mn-	γαμέτης	αᾱ
γαμουμένας	v-pppefa-	γαμεύω	αᾱ
γήμας	v-sapamn-	γαμέω	ᾱ
γεγυμνάκασιν	v3pria---	γεγυμνάκασιν	αᾱ
γέννας	n-p---fa-	γέν	ᾱ
γενειάδας	n-p---fa-	γενειάς	αᾱ
γενέτα	n-s---mv-	γενέτης	ᾱ
γενέταν	n-s---ma-	γενέτης	ᾱ
γενέτας	n-s---mn-	γενέτης	ᾱ
γέννας	n-s---fg-	γέννα	ᾱ
γενναίας	a-s---fg-	γενναῖος	ᾱ
γέννας	n-s---fg-	γέννας	ᾱ
γεννήσας	v-sapamn-	γεννάω	ᾱ
γεραιάς	a-p---fa-	γεραιός	ᾱ
γεραιάς	a-p---fa-	γεραιός	ᾱ
γεραιὰς	a-p---fa-	γεραιός	ᾱ
γέρας	n-s---na-	γέρας	ᾱ
γέρας	n-s---nn-	γέρας	ᾱ
γεφύρας	n-p---fa-	γέφυρα	ᾱ
γηγενέτας	a-s---mn-	γηγενέτας	ᾱ
γίγας	n-s---mn-	γίγας	ᾱ
γλυφίδας	n-p---fa-	γλυφίς	ᾱ
γλώσσας	n-p---fa-	γλῶσσα	ᾱ
γνώμας	n-p---fa-	γνώμη	ᾱ
γνώμας	n-s---fg-	γνώμη	ᾱ
γονάς	n-p---fa-	γονάς	ᾱ
γονάς	n-p---fa-	γονή	ᾱ
γονὰς	n-p---fa-	γονή	ᾱ
γονίας	n-s---fg-	γονία	ᾱ
Γοργόνας	n-p---fa-	Γοργόνες	Ᾱ
γραίας	n-s---fg-	γραεία	ᾱ
γραίας	n-p---fa-	γραῖος	ᾱ
γραίας	n-s---fg-	γραῖος	ᾱ
γραίας	a-p---fa-	γραῖος	ᾱ
γραφάς	n-p---fa-	γραφή	αᾱ
γραφάς	n-p---fa-	γραφή	αᾱ
γραφὰς	n-p---fa-	γραφή	αᾱ
γεγραμμένας	v-prpefa-	γράφω	αᾱ
γράψας	v-sapamn-	γράφω	αᾱ
γυᾶν	n-s---mn-	γυᾶν	ᾱ
γύας	n-s---mn-	γύης	ᾱ
γυίας	n-p---fa-	γυῖα	ᾱ
γυίας	n-p---fa-	γυίας	ᾱ
γυμνάς	a-p---fa-	γυμνός	ᾱ
γυμνὰς	a-p---fa-	γυμνός	ᾱ
γυναικείας	a-p---fa-	γυναικεῖος	ᾱ
γυπιάς	n-s---fg-	γυπιὰ	ᾱ
γυπιὰς	n-s---fg-	γυπιὰ	ᾱ
δᾴαν	v1saia---	δᾴαν	ᾱα
δαΐας	n-s---fg-	δαΐη	αᾱ
δαΐξας	v-sapamn-	δαΐξας	αᾱ
δακρῦον	n-s---nn-	δακρῦον	ῡ
δακρῦσαι	v--ana---	δακρύω	ῡ
δακρῦσαι	v--ana---	δακρύω	ῡ
δακρύσας	v-sapamn-	δακρύω	αᾱ
δακρῦσαι	v--ana---	δακρῦω	ῡ
δαμάλας	n-p---fa-	δαμάλη	ααᾱ
δαμίας	a-s---fg-	δάμιος	αᾱ
Δανάας	n-s---fg-	δανάη	Ααᾱ
δαναιᾶν	n-s---fa-	δαναιᾶ	αᾱ
Δαναϊδᾶν	n-p---mg-	Δαναϊδᾶν	Ααᾱ
Δαρδανίδας	n-s---mn-	Δαρδανίδης	Ααᾱ
Δαρδανίδας	n-p---fa-	Δαρδανίδης	Ααᾱ
Δαρδανίας	a-p---fa-	Δαρδανῖος	Ααᾱ
Δαριᾶνα	a-p---na-	Δαριᾶνος	Αᾱα
δατητάς	n-p---fa-	δατητάς	αᾱ
δατητὰς	n-p---fa-	δατητὰς	αᾱ
Δαυλίας	n-p---fa-	Δαυλία	Ᾱ
δάφνας	n-s---fg-	δάφ	αᾱ
δάφνας	n-p---fa-	δάφνη	αᾱ
δείσας	v-sapamn-	δείδω	ᾱ
Δείκνυμι	v1spia---	δείκνυμι	Ῡ
δεικνύς	v-sppamn-	δείκνυμι	ῡ
δεικνὺς	v-sppamn-	δείκνυμι	ῡ
δείκνυσιν	v3spia---	δείκνυμι	ῡ
δείξας	v-sapamn-	δείκνυμι	ᾱ
δειλαίας	a-s---fg-	δείλαιος	ᾱ
δειλίᾳ	n-s---fd-	δειλία	ᾱ
δειλίας	n-s---fg-	δειλία	ᾱ
δεινάς	a-p---fa-	δεινός	ᾱ
δεινάς	a-p---fa-	δεινός	ᾱ
δεινὰς	a-p---fa-	δεινός	ᾱ
δεινοτάτας	a-s---fgs	δεινός	αᾱ
δειράδας	n-p---fa-	δειράδας	αᾱ
δειράδας	n-p---fa-	δειράς	αᾱ
δέμας	n-s---nn-	δέμας	ᾱ
δέμας	n-s---na-	δέμας	ᾱ
δεξιᾶι	a-p---fn-	δεξιᾶι	ᾱ
δεξιᾶι	a-s---fd-	δεξιᾶι	ᾱ
δεξιᾶς	u--------	δεξιᾶς	ᾱ
δεξιάς	a-p---fa-	δεξιός	ᾱ
δεξιᾶς	a-s---fg-	δεξιός	ᾱ
δεξιᾶς	a-p---fa-	δεξιός	ᾱ
δέπας	n-s---na-	δέπας	ᾱ
δέρας	n-p---fa-	δέρη	ᾱ
δέραν	n-s---ma-	δέρης	ᾱ
δεσποίνας	n-s---fg-	δέσποινα	ᾱ
δεσπόταν	n-s---ma-	δεσπότης	ᾱ
δήσας	v-sapamn-	δέω	ᾱ
δέρας	n-p---fa-	δήρ	ᾱ
διαβάς	v-sapamn-	διαβαίνω	αᾱ
διαβὰς	v-sapamn-	διαβαίνω	αᾱ
διαγελᾶις	v2spsa---	διαγελᾶις	αᾱ
διαγελᾶις	v2spia---	διαγελᾶις	αᾱ
διαδρομᾶν	v--pna---	διαδρομάω	αᾱ
διαίτᾳ	a-s---fd-	διαί	ᾱ
διαιτᾶσθαι	v--pne---	διαιτᾶμαι	ᾱ
διαιτᾶσθαι	v--pne---	διαιτάομαι	ᾱ
διακωλῦσαι	v--ana---	διακωλύω	ῡ
διαλλαγάς	n-p---fa-	διαλλαγή	ααᾱ
διαλλαγάς	n-p---fa-	διαλλαγή	ααᾱ
διαλλαγὰς	n-p---fa-	διαλλαγή	ααᾱ
διαμείψας	v-sapamn-	διαμείπτω	αᾱ
διαμοιρᾶσαι	v--ana---	διαμοιρᾶζω	αᾱ
διανοίᾳ	n-s---fd-	διάνοια	αᾱ
διανοίας	n-s---fg-	διάνοια	αᾱ
διανοίας	n-p---fa-	διάνοια	αᾱ
διανομάς	n-p---fa-	διανομή	αᾱ
διανομὰς	n-p---fa-	διανομή	αᾱ
διαπείρας	n-p---fa-	διαπείρη	αᾱ
διαπερᾶν	v--pna---	διαπερᾶ	αᾱ
διαπερᾶν	a-s---fa-	διαπεράω	αᾱ
διαπήλας	v-sapamn-	διαπήλλω	αᾱ
διαπωτᾶται	v3spie---	διαπωτάομαι	αᾱ
διαρροάς	n-p---fa-	διαρροάς	αᾱ
διασιωπήσας	v-sapamn-	διασιωπάω	αᾱ
διᾴσσει	v3spia---	διᾴσσει	ᾱ
διαφθοράς	n-p---fa-	διαφθορά	αᾱ
διαφθοράς	n-p---fa-	διαφθορὰ	αᾱ
διαφθορὰς	n-p---fa-	διαφθορὰ	αᾱ
διαφθοράς	n-p---fa-	διαφθοράς	αᾱ
διαχαλᾶτε	v2prma---	διαχαλάω	ααᾱ
διδύμας	a-s---fg-	διδύμας	ᾱ
διεκπερᾶν	v--pna---	διεκπεράω	ᾱ
διεμπολᾷ	v1saia---	διεμπολᾷ	ᾱ
διελθούσας	v-papafa-	διέρχομαι	ᾱ
δικαίας	a-p---fa-	δίκαιος	ᾱ
δικαίας	a-s---fg-	δίκαιος	ᾱ
δικέλλας	n-p---fa-	δικέλλη	ᾱ
δίκᾳ	n-s---fd-	δίκη	ᾱ
Δίκᾳ	a-p---na-	δίκη	Ᾱ
δίκας	n-s---fg-	δίκη	ᾱ
δίκας	n-p---fa-	δίκη	ᾱ
Δίκας	n-p---fa-	δίκη	Ᾱ
Δίκας	n-s---fg-	δίκη	Ᾱ
δίνᾳ	u--------	δίνᾳ	ᾱ
δῖναινεφέλας	n-p---fa-	δῖναινεφέλη	ῑᾱ
δίνας	n-p---fa-	δίνας	ᾱ
δίνας	n-p---fa-	δίνη	ᾱ
διολέσας	v-sapamn-	διολέθω	ᾱ
διολέσας	v-sapamn-	διόλλυμι	ᾱ
διολλῦσαι	v-pppafn-	διολλῦσαι	ῡ
διόπτας	v-sapamn-	διόπτης	ᾱ
δίας	a-s---fg-	δῖος	ᾱ
δίας	n-s---fg-	δῖος	ᾱ
διώσας	v-sapamn-	διόω	ᾱ
διπλᾶ	u--------	διπλᾶ	ᾱ
διπλᾶ	a-p---na-	διπλόος	ᾱ
διπλᾶ	a-p---nn-	διπλόος	ᾱ
διπλᾶς	a-p---fa-	διπλόος	ᾱ
Δίρκας	a-s---fg-	Δίρκη	Ᾱ
Δίρκας	a-p---fa-	Δίρκος	Ᾱ
δισσάς	a-p---fa-	δισσάς	ᾱ
δισσάς	a-p---fa-	δισσάς	ᾱ
δισσὰς	a-p---fa-	δισσὰς	ᾱ
δμωίδας	n-p---fa-	δμωίδας	ᾱ
δνοφεράς	a-p---fa-	δνοφερὰ	ᾱ
δνοφερὰς	a-p---fa-	δνοφερὰ	ᾱ
δοθείσας	v-prpefa-	δοθείσας	ᾱ
δοκήσας	v-sapamn-	δοκέω	ᾱ
δόξας	v-sapamn-	δοκέω	ᾱ
δολίας	a-p---fa-	δολί	ᾱ
δολίας	a-s---fg-	δολῖος	ᾱ
δολώσας	v-sapamn-	δολόω	ᾱ
δολώσας	v-sapamn-	δολώσας	ᾱ
δόξας	n-p---fa-	δόξα	ᾱ
δοράς	n-p---fa-	δορά	ᾱ
δορὰς	n-p---fa-	δορά	ᾱ
Δοτάμας	n-s---nn-	Δοτάμας	Αᾱ
δουλείας	n-s---fg-	δουλεία	ᾱ
δουλίας	a-s---fg-	δουλεία	ᾱ
δούλας	n-s---fg-	δούλη	ᾱ
δουλίᾳ	a-p---nn-	δουλίᾳ	ᾱ
δουλοσύνας	n-s---fg-	δουλοσύνα	ᾱ
δουλώσας	v-sapamn-	δουλόω	ᾱ
δοχμιᾶν	a-s---fa-	δοχμιᾶν	ᾱ
δραπέταν	v3siia---	δραπέταν	αᾱ
δράσας	v-sapamn-	δράσας	αᾱ
δράσας	v-sapamn-	δράω	αᾱ
δράτω	v3spma---	δράω	ᾱ
Δράτω	v3spma---	δράω	Ᾱ
δρομάς	n-p---fa-	δρομή	ᾱ
δρομὰς	n-p---fa-	δρομή	ᾱ
δροσεράς	a-p---fa-	δροσερός	ᾱ
δροσερὰς	a-p---fa-	δροσερός	ᾱ
δύᾳ	u--------	δύᾳ	ᾱ
δύᾳ	a-p---nn-	δύᾳ	ᾱ
δύας	n-p---fa-	δύας	ᾱ
δύας	n-p---fa-	δύες	ᾱ
δύᾳ	n-s---fn-	δύη	ᾱ
δύας	n-p---fa-	δύη	ᾱ
δύνᾳ	v1siia---	δύνᾳ	ᾱ
δύνᾳ	v2spma---	δύνᾳ	ᾱ
δύνᾳ	v2spie---	δύνᾳμι	ᾱ
δυναστείας	n-s---fg-	δυναστεία	αᾱ
δυνάστα	n-s---mv-	δυνάστης	αᾱ
δυνάστας	n-s---mn-	δυνάστης	αᾱ
δυσαυλίας	n-s---fg-	δυσαυλία	ᾱ
δυσβουλίας	n-s---fg-	δυσβουλία	ᾱ
δυσγενείας	n-s---fg-	δυσγενεία	ᾱ
δυσθυμίας	n-s---fg-	δυσθυμία	ᾱ
δυσκλεᾶ	a-s---fa-	δυσκλεᾶ	ᾱ
δυσκλεᾶς	a-s---mn-	δυσκλεᾶς	ᾱ
δυσκλείᾳ	n-s---fd-	δύσκλεια	ᾱ
δυσμᾶν	v2sama---	δυσμᾶν	ᾱ
δυσμενείᾳ	n-s---fd-	δυσμενεία	ᾱ
δυσοσμίας	n-s---fg-	δυσοσμία	ᾱ
δυσπραξίας	n-p---fa-	δυσπραξία	αᾱ
δυσπραξίας	n-s---fg-	δυσπραξία	αᾱ
δυσσεβείας	n-s---fg-	δυσσεβείη	ᾱ
δυσσεβίας	a-s---fg-	δυσσεβῖος	ᾱ
δυστανοτάτας	a-s---fgs	δυστανός	ααᾱ
δυστανοτάτας	a-p---fas	δυστανοτάτας	ααᾱ
δυσχλαινίας	n-p---fa-	δυσχλαινία	ᾱ
δωματῖτιν	n-s---fa-	δωματῖτιν	ῑι
Δωρικάς	a-p---fa-	Δωρικά	Ᾱ
ἔα	v2spma---	ἔα	ᾱ
Ἔα	v2spma---	ἔα	Ᾱ
ἐαεὐνάς	n-p---fa-	ἐαεὐνάς	αᾱ
ἔαεὐνας	n-p---fa-	ἔαεὐνὰς	αᾱ
ἔα	v2spma---	ἐάω	ᾱ
Ἔα	v2spma---	ἐάω	Ᾱ
ἐάσας	v-sapamn-	ἐάω	αᾱ
εἴα	v3siia---	ἐάω	ᾱ
ἑβδόμας	a-p---fa-	ἕβδομος	ᾱ
ἐγκαθηβᾶν	v1saia---	ἐγκαθηβάω	αᾱ
ἐγκαθιδρῦσαι	v--ana---	ἐγκαθιδρῦζω	ῡ
ἐγκαταζεύξας	v-sapamn-	ἐγκαταζεύσσω	ααᾱ
ἐγκατιλλώψας	v-sapamn-	ἐγκατιλλώπτω	αᾱ
ἐγκλῄσας	v-sapamn-	ἐγκλείω	ᾱ
ἔδρας	n-p---fa-	ἔδρα	ᾱ
ἕδρας	n-p---fa-	ἕδρα	ᾱ
ἕδρας	n-s---fg-	ἕδρα	ᾱ
ἐθείρας	v-sapamn-	ἐθείρω	ᾱ
εἰδυίας	v-sppafg-	εἰδυίας	ᾱ
εἰλαπίνας	n-p---fa-	εἰλαπίνη	αᾱ
εἰλατίνας	a-p---fa-	εἰλατίνη	αᾱ
εἰληγμένας	v-prpefa-	εἰληγμένας	ᾱ
εἱλιςσομένας	n-s---fg-	εἱλις	ᾱ
εἱλίξας	v-sapamn-	εἱλίσσω	ᾱ
εἱλόμανἀνατροπας	n-p---fa-	εἱλόμανἀνατροπάς	αααᾱ
οὔσας	v-pppafa-	εἰμί	ᾱ
ἰούσας	v-pppafa-	εἶμι	ᾱ
εἰναλίας	a-p---fa-	εἰναλίη	αᾱ
εἰναλίας	a-s---fg-	εἰναλῖος	αᾱ
εἰρεσίας	n-s---fg-	εἰρεσία	ᾱ
μιᾷ	a-s---fd-	εἷς	ᾱ
μιᾶς	a-s---fg-	εἷς	ᾱ
Μιᾶς	a-s---fg-	εἷς	Ᾱ
εἰσακούσας	v-sapamn-	εἰσακούω	αᾱ
ἐσβολάς	n-p---fa-	εἰσβολή	ᾱ
εἰσόρα	v2spma---	εἰσόρα	ᾱ
εἰσορᾶτε	v2ppia---	Εἰσορᾶτέ	ᾱ
Ἑκάτας	n-s---fg-	Ἑκάτα	Αᾱ
ἐκβάς	v-sapamn-	ἐκβαίνω	ᾱ
ἐκβὰς	v-sapamn-	ἐκβαίνω	ᾱ
ἐκβακχευσαμένα	v-dapmfn-	ἐκβακχευσαμένα	ααᾱ
ἐκβολάς	n-p---fa-	ἐκβολάς	ᾱ
ἐκβολάς	n-p---fa-	ἐκβολή	ᾱ
ἐκβολὰς	n-p---fa-	ἐκβολή	ᾱ
ἐκδακρῦσαι	v2spie---	ἐκδακρῦσαί	ῡ
ἐκδακρῦσαι	v2spie---	ἐκδακρῦσω	ῡ
ἐκείνας	a-p---fa-	ἐκεῖνος	ᾱ
κείνας	a-p---fa-	ἐκεῖνος	ᾱ
ἐκκαλύψας	v-sapamn-	ἐκκαλύπτω	αᾱ
ἐκκενουμένα	v-dppefn-	ἐκκενουμένα	ᾱ
ἐκκλησίας	n-p---fa-	ἐκκλησία	ᾱ
ἐκκολυμβᾶν	v3siia---	ἐκκολυμβάω	ᾱ
ἐκκομπάσας	v-sapamn-	ἐκκομπάζω	αᾱ
ἐκνικᾶι	v3spoa---	ἐκνικᾶι	ᾱ
ἑκούσας	v-pppafa-	ἑκούσας	ᾱ
ἐκπέμψας	v-sapamn-	ἐκπέμπω	ᾱ
ἐκπεφεύγασιν	v3pria---	ἐκπεφεύγασιν	ᾱ
ἐκπλήσας	v-sapamn-	ἐκπλέω	ᾱ
ἐκπνεούσας	v-pppafa-	ἐκπνεούσας	ᾱ
ἐκπνεύσας	v-sapamn-	ἐκπνεύω	ᾱ
ἐκπράξας	v-sapamn-	ἐκπράκω	αᾱ
ἐκπράξας	v-sapamn-	ἐκπράσσω	αᾱ
ἐκτελευτήσας	v-sapamn-	ἐκτελευτάω	ᾱ
ἐκΤροίας	a-p---fa-	ἐκΤροίας	Ᾱ
ἐκτροπάς	n-p---fa-	ἐκτροπή	ᾱ
ἐκφύς	v-sapamn-	ἐκφύομαι	ῡ
ἐκφὺς	v-sapamn-	ἐκφύομαι	ῡ
ἐκφύς	v-sapamn-	ἐκφύς	ῡ
ἐκφυσᾷ	v-sapafn-	ἐκφυσᾷ	ᾱ
ἐκχέας	v-sapamn-	ἐκχέω	ᾱ
ἔλα	v2spma---	ἔλα	ᾱ
ἐλαίας	n-s---fg-	ἐλαί	ᾱ
ἐλαίας	n-s---fg-	ἐλαία	ᾱ
ἐλαίας	n-p---fa-	ἐλαία	ᾱ
ἐλατᾶν	n-s---fa-	ἐλατᾶν	αᾱ
ἐλάτας	n-p---fa-	ἐλάτη	αᾱ
ἐλέγξας	v-sapamn-	ἐλέγγω	ᾱ
ἑλένας	n-s---fg-	ἑλένα	ᾱ
Ἑλένας	n-s---fg-	Ἑλένη	Ᾱ
ἐλευθερίᾳ	n-s---fd-	ἐλευθερία	ᾱ
ἐλευθερίας	n-s---fg-	ἐλευθερία	ᾱ
ἐλευθέρας	a-p---fa-	ἐλεύθερος	ᾱ
ἐλευθερώσας	v-sapamn-	ἐλευθερόω	ᾱ
Ἐλευσινίας	a-s---fg-	Ἐλευσινῖος	Ᾱ
ἑλίξας	v-sapamn-	ἑλίσσω	ᾱ
Ἑλλανίας	n-s---fg-	Ἑλλανίη	Αᾱ
Ἑλλανίας	a-p---fa-	Ἑλλανῖος	Αᾱ
Ἑλληνίδας	a-p---fa-	ἑλληνίς	Ᾱ
Ἑλλανίας	a-s---fg-	Ἑλλίναος	Αᾱ
ἐλπίδας	n-p---fa-	ἐλπίς	ᾱ
ἐμβριμωμένας	v-prpefa-	ἐμβριμωμένας	ᾱ
ἐμάς	a-p---fa-	ἐμός	ᾱ
ἐμάς	a-p---fa-	ἐμός	ᾱ
ἐμάς	a-s---fg-	ἐμός	ᾱ
ἐμὰς	a-p---fa-	ἐμός	ᾱ
ἐμὰς	a-s---fg-	ἐμός	ᾱ
ἐμπολήσας	v-sapamn-	ἐμπολάω	ᾱ
ἐμπρήσας	v-sapamn-	ἐμπρέω	ᾱ
ἐναλίας	a-s---fg-	ἐναλία	αᾱ
ἐναλίας	a-s---fg-	ἐναλίος	αᾱ
ἐναλίας	a-s---fg-	ἐναλῖος	αᾱ
ἐναρμόσας	v-sapamn-	ἐναρμόζω	αᾱ
ἐνδείκνυσιν	v3ppia---	ἐνδείκνυσιν	ῡ
ἐνδυναστεύσας	v-sapamn-	ἐνδυναστεύω	αᾱ
ἐνδύς	v-sapamn-	ἐνδύω	ῡ
ἐνζεύξας	v-sapamn-	ἐνζεύγνυμι	ᾱ
ἐνθουσιᾶις	n-p---fd-	ἐνθουσιᾶ	ᾱ
ἐννυχιᾶν	a-s---fa-	ἐννυχιᾶ	ᾱ
Ἐνοδίας	n-s---fg-	Ἐνοδίη	Ᾱ
ἐνσείσας	v-sapamn-	ἐνσείω	ᾱ
ἐξάρας	v-sapamn-	ἐξαίρω	αᾱ
ἐξακοντίσας	v-sapamn-	ἐξακοντίω	αᾱ
ἐξαλλάξας	v-sapamn-	ἐξαλλάσσω	ααᾱ
ἐξαλύξας	v-sapamn-	ἐξαλύγνυμι	αᾱ
ἐξαμᾷ	v3saia---	ἐξαμάω	αᾱ
ἐξαμείψας	v-sapamn-	ἐξαμείπτω	αᾱ
ἐξαναρπάσας	v-sapamn-	ἐξαναρπάζω	αααᾱ
ἐξανασπάσας	v-sapamn-	ἐξανασπάζω	αααᾱ
ἐξαναστήσας	v-sapamn-	ἐξανίστημι	ααᾱ
ἐξανύσας	v-sapamn-	ἐξανύω	αᾱ
ἐξάψας	v-sapamn-	ἐξάπτω	αᾱ
ἐξαρκέσας	v-sapamn-	ἐξαρκέω	αᾱ
ἐξαρπάσας	v-sapamn-	ἐξαρπάω	ααᾱ
ἐξαύδα	v2spma---	ἐξαύδα	ᾱ
ἐξαυδωμένας	v-pppefa-	ἐξαυδάομαι	ᾱ
ἐξαύδα	v2spma---	ἐξαυδάω	ᾱ
ἐξέβας	v-sapamn-	ἐξέβας	ᾱ
ἐξεβρυχᾶτ’	v3plie---	ἐξεβρυχᾶτ	ᾱ
ἐξερευνήσας	v-sapamn-	ἐξερευνήζω	ᾱ
ἐξερευνήσας	v-sapamn-	ἐξερευνήω	ᾱ
ἐξερημώσας	v-sapamn-	ἐξερημόω	ᾱ
ἐξημερώσας	v-sapamn-	ἐξημερόω	ᾱ
ἐξηρτυμένας	v-prpefa-	ἐξηρτυμένας	ᾱ
ἐξιᾶσι	v3ppia---	ἐξιᾶμι	ᾱ
ἐξιστορήσας	v-sapamn-	ἐξιστορέω	ᾱ
ἐξορίνας	v-sapamn-	ἐξορίνω	ᾱ
ἐξορμωμένας	v-pppefa-	ἐξορμωμένας	ᾱ
ἐξωινωμένας	v-pppefa-	ἐξωινωμένας	ᾱ
ἐξώρμα	v3siia---	ἐξώρμα	ᾱ
ἑορτάς	n-p---fa-	ἑορτή	ᾱ
ἑορτάς	n-p---fa-	ἑορτή	ᾱ
ἑορτὰς	n-p---fa-	ἑορτή	ᾱ
ἐπαινέσας	v-sapamn-	ἐπαινέω	ᾱ
ἐπάρας	v-sapamn-	ἐπαίρω	αᾱ
ἐπαιτιᾷ	v2spie---	ἐπαιτιᾷ	ᾱ
ἐπαιτιᾷ	v2spie---	ἐπαιτιάομαι	ᾱ
ἐπακτίᾳ	a-s---fd-	ἐπακτίᾳς	αᾱ
ἐπαξιώσας	v-sapamn-	ἐπαξιόω	αᾱ
ἐπέβα	v3siia---	ἐπέβα	ᾱ
ἐπεικάσας	v-sapamn-	ἐπεικάσας	αᾱ
ἐπεμβάς	v-sapamn-	ἐπεμβαίνω	ᾱ
ἐπεμβὰς	v-sapamn-	ἐπεμβαίνω	ᾱ
ἐπεξιακχάσας	v-sapamn-	ἐπεξιακχάσας	ααᾱ
ἐπερειδομένας	v-prpefa-	ἐπερειδομένας	ᾱ
ἐπιστάς	v-sapamn-	ἐπι	ᾱ
ἐπιστὰς	v-sapamn-	ἐπι	ᾱ
ἐπιβᾶσαι	v--ana---	ἐπιβᾶθω	ᾱ
ἐπιβάς	v-sapamn-	ἐπιβαίνω	ᾱ
ἐπιβὰς	v-sapamn-	ἐπιβαίνω	ᾱ
ἐπιβᾶσ’	v-sapafn-	ἐπιβᾶσ	ᾱ
ἐπίβα	v2spma---	ἐπιβάω	ᾱ
ἐπιγλωσσᾷ	a-s---fn-	ἐπιγλωσσάω	ᾱ
ἐπιδρομάς	n-p---fa-	ἐπιδρομή	ᾱ
ἐπιδρομάς	n-p---fa-	ἐπιδρομή	ᾱ
ἐπιδρομὰς	n-p---fa-	ἐπιδρομή	ᾱ
ἐπιθύσας	v-sapamn-	ἐπιθύζω	ᾱ
ἐπικεκλιμένας	v-prpefa-	ἐπικεκλιμένας	ᾱ
ἐπικρᾶναι	v--ana---	ἐπικρᾶναι	ᾱ
ἐπιλαβάς	n-p---fa-	ἐπιλαβή	αᾱ
ἐπιλαβὰς	n-p---fa-	ἐπιλαβή	αᾱ
ἐπινωμᾷ	v1spia---	ἐπινωμᾷ	ᾱ
ἐπινωμᾷ	n-s---nn-	ἐπινωμᾷ	ᾱ
ἐπινωμᾶν	v1saom---	ἐπινωμᾶν	ᾱ
ἐπενώμα	v3siia---	ἐπινωμάω	ᾱ
ἐπινωτίσας	v-sapamn-	ἐπινωτίδω	ᾱ
ἐπιπλοίας	n-p---fa-	ἐπιπλοίη	ᾱ
ἐπιπνεύσας	v-sapamn-	ἐπιπνεύω	ᾱ
ἐπιπνοίας	n-s---fg-	ἐπιπνοία	ᾱ
ἐπιρροάς	a-p---fa-	ἐπιρροάς	ᾱ
ἐπισπάσας	v-sapamn-	ἐπισπάω	αᾱ
ἐπίστᾳ	v2spme---	ἐπίστᾳ	ᾱ
ἐπίστᾳ	v2spie---	ἐπίστᾳ	ᾱ
ἐπιστᾶσαι	v2spie---	ἐπιστᾶμαι	ᾱ
ἐπιστολάς	n-p---fa-	ἐπιστολάς	ᾱ
ἐπιστολάς	n-p---fa-	ἐπιστολή	ᾱ
ἐπιστολάς	n-p---fa-	ἐπιστολή	ᾱ
ἐπιστολὰς	n-p---fa-	ἐπιστολή	ᾱ
ἐπιστρέψας	v-sapamn-	ἐπιστρέφω	ᾱ
ἐπιστροφάς	n-p---fa-	ἐπιστροφή	ᾱ
ἐπιστροφάς	a-p---fa-	ἐπιστροφή	ᾱ
ἐπιστροφὰς	a-p---fa-	ἐπιστροφή	ᾱ
ἐπιστρωφᾶι	v2spie---	ἐπιστρωφᾶι	ᾱ
ἐπισφάξας	v-sapamn-	ἐπισφάσσω	αᾱ
ἐπιχαλᾷς	v2spsa---	ἐπιχαλάω	αᾱ
ἐποικτίρας	v-sapamn-	ἐποικτείρω	ᾱ
ἐπόμνυς	v-sppamn-	ἐπόμνυς	ῡ
ἐποπτεύσας	v-sapamn-	ἐποπτεύω	ᾱ
ἐπτοημένας	v-prpefa-	ἐπτοημένας	ᾱ
ἐπῳδάς	n-p---fa-	ἐπῳδή	ᾱ
ἐπῳδὰς	n-p---fa-	ἐπῳδή	ᾱ
ἐπωμίδας	n-p---fa-	ἐπωμίς	ᾱ
ἐπωνυμίᾳ	n-s---fd-	ἐπωνυμία	ᾱ
ἐπωπάς	n-p---fa-	ἐπωπή	ᾱ
ἐπωφελήσας	v-sapamn-	ἐπωφελάω	ᾱ
ἔρα	v2spma---	ἔρα	ᾱ
ἐραστάς	a-p---fa-	ἐραστός	αᾱ
ἐραστὰς	a-p---fa-	ἐραστός	αᾱ
ἔρξας	v-sapamn-	ἔρδω	ᾱ
ἐρείσας	v-sapamn-	ἐρείδω	ᾱ
ἐρευνάσας	v-sapamn-	ἐρευνάω	αᾱ
Ἐρεχθεϊδᾶν	n-p---mg-	Ἐρεχθεῖδαϊ	Ᾱ
ἐρήμας	a-p---fa-	ἐρήμας	ᾱ
ἐρημίας	n-s---fg-	ἐρημία	ᾱ
ἐρημίας	n-s---fg-	ἐρημίας	ᾱ
ἐρημώσας	v-sapamn-	ἐρημώζω	ᾱ
Ἐριβοίᾳ	a-s---fv-	Ἐριβοίᾳ	Ᾱ
Ἐρινῦς	n-s---fn-	ἐρινύς	Ῡ
Ἐρινῦς	n-p---fa-	ἐρινύς	Ῡ
Ἐρινῦς	n-s---fn-	Ἐρινῦς	Ῡ
ἐρίπνας	a-p---fa-	ἐρίπνας	ᾱ
ἐρίπνας	a-p---fa-	ἐρίπνη	ᾱ
ἑρκείας	a-p---fa-	ἑρκεῖος	ᾱ
Ἑρμιόναν	n-s---ma-	Ἑρμιόνης	Ᾱ
Ἐρυθείας	n-s---fg-	Ἐρυθεία	Ᾱ
Ἐρυθράς	a-p---fa-	Ἐρυθρός	Ᾱ
ἐρυμνᾶς	p-s---fa-	ἐρυμι	ᾱ
ἐρωτήσας	v-sapamn-	ἐρωτάω	ᾱ
ἐσβολάς	n-p---fa-	ἐσβολή	ᾱ
ἐσβολὰς	n-p---fa-	ἐσβολή	ᾱ
ἐσθλάς	a-p---fa-	ἐσθλός	ᾱ
ἐσθλὰς	a-p---fa-	ἐσθλός	ᾱ
ἑστίας	n-s---fg-	ἑστία	ᾱ
Ἑστίας	n-s---fg-	Ἑστία	Ᾱ
ἑστίᾳ	n-d---fn-	ἑστίᾳ	ᾱ
ἑστίας	n-s---fg-	ἑστῖα	ᾱ
ἑστιᾶι	v3spsa---	ἑστιᾶι	ᾱ
ἑστίας	n-s---fg-	ἑστίας	ᾱ
ἑστίας	n-s---fg-	ἑστίη	ᾱ
ἐστολισμένας	v-prpefa-	ἐστολισμένας	ᾱ
ἐσφάδᾳζε	v3siia---	ἐσφάδᾳζε	αᾱ
ἐσχάρᾳ	n-s---fd-	ἐσχάρη	αᾱ
ἐσχάρας	n-p---fa-	ἐσχάρη	αᾱ
ἐσχάρας	n-s---fg-	ἐσχάρη	αᾱ
ἐσχάτας	a-p---fa-	ἔσχατος	αᾱ
ἐσχάτας	a-s---fg-	ἔσχατος	αᾱ
ἑταιρείας	n-s---fg-	ἑταιρεία	ᾱ
ἑταιρίας	n-s---fg-	ἑταιρία	ᾱ
ἑτέρας	a-p---fa-	ἕτερος	ᾱ
ἐτιμᾶτ’	v2piia---	ἐτιμᾶτ	ᾱ
ἑτοιμάσας	v-sapamn-	ἑτοιμάζω	αᾱ
ἐτείας	a-s---fg-	ἐτύς	ᾱ
Εὐβοίας	n-s---fg-	εὔβοια	Ᾱ
εὐβουλίας	n-s---fg-	εὐβουλία	ᾱ
Εὐβουλίας	n-s---fg-	εὐβουλία	Ᾱ
εὐβουλίᾳ	n-s---fn-	εὐβουλίᾳ	ᾱ
εὐγενείας	n-s---fg-	εὐγενεία	ᾱ
εὐγενίας	n-s---fg-	εὐγενί	ᾱ
εὐγενίας	n-s---fg-	εὐγενία	ᾱ
εὐδαιμονίας	n-s---fg-	εὐδαιμονία	ᾱ
εὐδίᾳ	n-s---fd-	εὐδία	ᾱ
εὐδοξίας	n-s---fg-	εὐδοξία	ᾱ
εὐεπείας	n-s---fg-	εὐέπεια	ᾱ
εὐεργέταν	n-s---ma-	εὐεργέτης	ᾱ
εὐθυντηρίας	n-s---fg-	εὐθυντηρία	ᾱ
εὐκλεεστάτας	a-s---fgs	εὐκλεεστάτας	αᾱ
εὐκλείας	n-s---fg-	εὔκλεια	ᾱ
εὐκοσμίας	n-p---fa-	εὐκοσμίη	ᾱ
εὐλογίας	n-s---fg-	εὐλογία	ᾱ
εὐλύρας	n-s---mn-	εὐλύρης	ᾱ
εὐμαρείᾳ	n-s---fd-	εὐμαρεία	αᾱ
εὐμενείας	n-p---fa-	εὐμένεια	ᾱ
Εὐμενίδας	n-p---fa-	Εὐμενίδας	Ᾱ
Εὐμολπιδᾶν	a-s---fa-	Εὐμολπιδᾶν	Ᾱ
εὐναίας	a-p---fa-	εὐναῖος	ᾱ
εὐνᾶιπόσιν	n-p---md-	εὐνᾶιπών	ᾱ
εὐνάς	n-p---fa-	εὐνάς	ᾱ
εὐνάς	n-p---fa-	εὐνή	ᾱ
εὐνάς	n-p---fa-	εὐνή	ᾱ
εὐνὰς	n-p---fa-	εὐνή	ᾱ
εὐνοίας	n-p---fa-	εὔνοια	ᾱ
εὐνομίᾳ	n-p---na-	εὐνομίᾳ	ᾱ
εὐπατριδᾶν	n-s---ma-	εὐπατριδᾶν	αᾱ
εὐπατριδᾶν	n-s---ma-	εὐπατριδᾶς	αᾱ
εὐπατρίδαν	n-s---ma-	εὐπατρίδας	αᾱ
εὐπατρίδαν	a-s---ma-	εὐπατρίδας	αᾱ
εὐπετείας	n-s---fg-	εὐπέτεια	ᾱ
εὐπλοίας	n-p---fa-	εὔπλοια	ᾱ
εὐπραξίᾳ	n-s---fd-	εὐπραξία	αᾱ
εὐπραξίας	n-s---fg-	εὐπραξία	αᾱ
εὐπραξίας	n-s---fg-	εὔπραξια	αᾱ
Εὐρώπαν	n-s---ma-	Εὐρώπας	Ᾱ
Εὐρωπίας	n-s---fg-	Εὐρωπία	Ᾱ
Εὐρώτα	n-s---mg-	Εὐρώς	Ᾱ
Εὐρώταν	n-s---ma-	Εὐρώτας	Ᾱ
Εὐρώπας	a-p---fa-	Εὐρώψ	Ᾱ
Εὐρώτα	n-s---mg-	Εὐς	Ᾱ
εὐσεβείας	n-s---fg-	εὐσέβεια	ᾱ
εὐσεβίας	n-s---fg-	εὐσεβίας	ᾱ
εὐσοίας	n-s---fg-	εὔσοια	ᾱ
εὐσπλαγχνίας	n-p---fa-	εὐσπλαγχνίη	αᾱ
εὐτεκνίας	n-s---fg-	εὐτεκνία	ᾱ
εὐτυχήσας	v-sapamn-	εὐτυχέω	ᾱ
εὐτυχίας	n-s---fg-	εὐτυχία	ᾱ
εὐφαρέτραν	n-s---ma-	εὐφαρέτρης	αᾱ
εὐφρόνας	a-p---fa-	εὐφρόνας	ᾱ
εὐχά	v3siia---	εὐχάμι	ᾱ
εὐχάς	n-p---fa-	εὐχή	ᾱ
εὐχάς	n-p---fa-	εὐχή	ᾱ
εὐχὰς	n-p---fa-	εὐχή	ᾱ
εὐψυχίας	n-p---fa-	εὐψυχία	ᾱ
εὐψυχίας	n-s---fg-	εὐψυχία	ᾱ
εὐψυχίας	n-s---fg-	εὔψυχια	ᾱ
ἔφα	v3siia---	ἔφα	ᾱ
ἐφετμάς	n-p---fa-	ἐφετμάς	ᾱ
ἐφετμάς	n-p---fa-	ἐφετμή	ᾱ
ἐφετμὰς	n-p---fa-	ἐφετμή	ᾱ
ἐφημοσύνᾳ	n-p---na-	ἐφημοσύνᾳ	ᾱ
ἐφολκίδας	n-p---fa-	ἐφολκίς	ᾱ
ἐχθήρας	v-sapamn-	ἐχθεήρω	ᾱ
ἔχθρας	n-p---fa-	ἔχθρα	ᾱ
ἔχθρας	n-s---fg-	ἔχθρη	ᾱ
ἐχίδνας	n-p---fa-	ἐχίδνη	ᾱ
Ἐχίδνας	n-s---fg-	Ἐχίδνη	Ᾱ
Ἐχίνας	a-p---fa-	Ἐχίνας	Ᾱ
ἐχούσας	v-pppafa-	ἐχούσας	ᾱ
ἐχούσας	v-pppafa-	ἔχω	ᾱ
ζεύξας	v-sapamn-	ζεύγνυμι	ᾱ
ζημίας	n-s---fg-	ζημία	ᾱ
ζόας	n-s---fg-	ζόη	ᾱ
ζόας	n-p---fa-	ζόη	ᾱ
ζώνας	n-p---fa-	ζώνη	ᾱ
ζώσας	v-pppafa-	ζώσας	ᾱ
ζώσας	v-pppafa-	ζώω	ᾱ
ἥβας	v-sapamn-	ἥβη	ᾱ
ἥβας	n-p---fa-	ἥβη	ᾱ
ἥβας	n-s---fg-	ἥβη	ᾱ
Ἥβας	n-p---fa-	Ἥβη	Ᾱ
ἡδείας	a-s---fg-	ἡδεῖος	ᾱ
ἡδομένα	v-dppefn-	ἡδομένα	ᾱ
ἡδονάς	n-p---fa-	ἡδονή	ᾱ
ἡδονάς	n-p---fa-	ἡδονή	ᾱ
ἡδονὰς	n-p---fa-	ἡδονή	ᾱ
Ἠλέκτρας	n-s---fg-	Ἠλέκτρα	Ᾱ
ἁμερᾶν	n-s---fa-	ἡμερᾶ	αᾱ
ἡμέρας	n-p---fa-	ἡμέρα	ᾱ
ἡμέρας	n-s---fg-	ἡμέρα	ᾱ
ἡμετέρας	a-s---fg-	ἡμέτερος	ᾱ
ἡμετέρας	a-p---fa-	ἡμέτερος	ᾱ
ἡμιλλᾶτο	a-p---na-	ἡμιλλᾶτο	ᾱ
ἡνίας	n-s---fg-	ἡνία	ᾱ
ἡνίας	n-p---fa-	ἡνία	ᾱ
ἠπάτα	v3siia---	ἠπάτα	αᾱ
Ἥρας	n-s---fg-	ἥρα	Ᾱ
Ἥρας	n-p---fa-	ἥρα	Ᾱ
Ἡρακλείας	a-s---fg-	ἡράκλειος	Αᾱ
ἠρεμίας	n-s---fg-	ἠρεμίας	ᾱ
ᾑρήκασιν	v3pria---	ᾑρήκω	ᾱ
ἠρημωμένας	v-prpefa-	ἠρημωμένας	ᾱ
Ἥρα	n-s---mv-	Ἥρης	Ᾱ
ἡσυχίας	n-s---fg-	ἡσυχία	ᾱ
ηὔδα	v3siia---	ηὔδα	ᾱ
Ηὔδας	v2siia---	Ηὔδας	Ᾱ
θαλάμας	n-p---fa-	θαλάμας	ααᾱ
θαλάσσας	n-p---fa-	θαλάσσα	ααᾱ
θαλάσσας	n-s---fg-	θαλάσσα	ααᾱ
θαλάσσας	n-s---fg-	θαλάσσας	ααᾱ
θαλασσίας	a-s---fg-	θαλασσῖος	ααᾱ
θαλασσίας	a-p---fa-	θαλασσῖος	ααᾱ
θαλεράς	a-p---fa-	θαλερός	αᾱ
θαλερὰς	a-p---fa-	θαλερός	αᾱ
θανούσας	v-sapafg-	θανούθω	αᾱ
θάψας	v-sapamn-	θάπτω	αᾱ
θαρσήσας	v-sapamn-	θαρσέω	αᾱ
θἀτέρᾳ	a-p---nac	θἀτέρᾳ	αᾱ
θαυμάσας	v-sapamn-	θαυμάζω	αᾱ
θαυμάσας	v-sapamn-	θαυμάω	αᾱ
θεά	n-d---fn-	θεά	ᾱ
θεάς	n-s---fg-	θεά	ᾱ
θεάς	n-s---fg-	θεά	ᾱ
θεάς	n-p---fa-	θεά	ᾱ
θεὰς	n-s---fg-	θεά	ᾱ
θεὰς	n-p---fa-	θεά	ᾱ
θέας	n-s---fg-	θέα	ᾱ
θεάς	n-s---fg-	θεάς	ᾱ
θεάς	n-s---fg-	θεάς	ᾱ
θεάς	n-p---fa-	θεάς	ᾱ
θεὰς	n-s---fg-	θεὰς	ᾱ
θείας	n-s---fg-	θεία	ᾱ
θείας	a-s---fg-	θεῖος	ᾱ
θέλξας	v-sapamn-	θέλ	ᾱ
θελήσας	v-sapamn-	θελάω	ᾱ
θελούσας	v-pppafa-	θέλω	ᾱ
θεοσεβεστάτας	a-p---fa-	θεοσεβεστάτας	αᾱ
θεραπνᾶν	n-s---fa-	θεραπνᾶ	αᾱ
θερίσας	v-sapamn-	θερίσας	ᾱ
θερμάς	a-p---fa-	θερμός	ᾱ
θερμὰς	a-p---fa-	θερμός	ᾱ
θεσπεσίας	a-p---fa-	θεσπέσιος	ᾱ
θεσπίσας	v-sapamn-	θεσπίσας	ᾱ
Θεσσαλίας	n-s---fg-	Θεσσαλία	Αᾱ
Θεστιάς	n-s---fg-	Θεστιὰ	Ᾱ
Θεστιὰς	n-s---fg-	Θεστιὰ	Ᾱ
θεωρίας	n-s---fg-	θεωρία	ᾱ
Θήβας	v-sapamn-	Θή	Ᾱ
Θήβας	n-p---fa-	θῆβαι	Ᾱ
Θήβας	n-s---fg-	θῆβαι	Ᾱ
Θηβαΐας	a-p---fa-	θηβαῖος	Αᾱ
Θηβαίας	a-s---fg-	Θηβαῖος	Ᾱ
Θήβας	n-p---fa-	Θήβας	Ᾱ
Θήβας	n-s---fg-	θήβη	Ᾱ
θηγάνας	n-p---fa-	θηγάνη	αᾱ
θήκας	n-p---fa-	θήκη	ᾱ
θηλείας	a-s---fg-	θῆλυς	ᾱ
θηλείας	a-p---fa-	θῆλυς	ᾱ
θήρας	n-p---fa-	θήρας	ᾱ
Θησείδα	n-s---mg-	Θησείδα	Ᾱ
θιασώταν	n-s---ma-	θιασώτης	αᾱ
θιγάς	v-sapamn-	θιγάς	ᾱ
θιγὰς	v-sapamn-	θιγὰς	ᾱ
θνατᾶς	a-p---fa-	θνατᾶς	αᾱ
Θόας	a-p---fa-	θόας	Ᾱ
Θόας	a-s---fg-	θόας	Ᾱ
θοίνας	n-p---fa-	θοίνη	ᾱ
θοάς	a-p---fa-	θοός	ᾱ
θοὰς	a-p---fa-	θοός	ᾱ
θραύσας	v-sapamn-	θραύω	ᾱ
θρεομένας	v-sppefg-	θρεομένας	ᾱ
θρέψας	v-sapamn-	θρέπτω	ᾱ
θρεομένας	v-sppefg-	θρέω	ᾱ
Θρηικίας	a-p---fa-	Θρηικίας	Ᾱ
Θρηικίας	a-s---fg-	Θρηικῖος	Ᾱ
θραυομένας	v-sppefg-	θρήυω	ᾱ
τρίχας	n-p---fa-	θρίξ	ᾱ
θυγατέρας	n-p---fa-	θυγάτηρ	αᾱ
θυιάς	n-s---fg-	θυιὰ	ᾱ
θυιὰς	n-s---fg-	θυιὰ	ᾱ
θυιάς	a-p---fa-	θυιάς	ᾱ
θυιάς	a-s---fg-	θυιάς	ᾱ
θυιὰς	a-p---fa-	θυιὰς	ᾱ
θυιὰς	a-s---fg-	θυιὰς	ᾱ
θυμέλας	n-p---fa-	θυμέλας	ᾱ
θυμέλας	n-p---fa-	θυμέλη	ᾱ
θύρας	n-s---fg-	θύρα	ᾱ
θύρας	n-p---fa-	θύρα	ᾱ
θυραίᾳ	a-p---nn-	θυραίᾳ	ᾱ
θυραίας	a-s---fg-	θυραῖος	ᾱ
θυσίας	n-p---fa-	θυσία	ᾱ
θυσίας	n-s---fg-	θυσία	ᾱ
θυστάδας	a-p---fa-	θυστάς	αᾱ
θύσας	v-sapamn-	θύω	ᾱ
Ἴδας	n-s---fg-	Ἴ	Ᾱ
Ἰᾶσον	v2sama---	Ἰᾶσον	Ᾱ
ἰατορίας	n-s---mn-	ἰατορίας	αᾱ
ἰαχᾶι	n-p---fn-	ἰαχᾶι	αᾱ
ἰαχᾶς	n-p---fa-	ἰαχᾶς	αᾱ
Ἰδαιᾶν	a-s---fa-	Ἰδαιᾶ	Ᾱ
Ἰδαιᾶν	a-s---fa-	Ἰδαιᾶν	Ᾱ
Ἰδαίας	a-s---fg-	̓ἰδαῖος	Ᾱ
Ἴδας	n-p---fa-	Ἴδη	Ᾱ
ἰδίᾳ	a-s---fd-	ἴδιος	ᾱ
ἰδίας	a-s---fg-	ἴδιος	ᾱ
ἰδίας	a-p---fa-	ἴδιος	ᾱ
ἱδρύσας	v-sapamn-	ἱδρύζω	ᾱ
ἱδρυμένας	v-prpefa-	ἱδρυμένας	ᾱ
ἱδρῦσθαι	v--rne---	ἱδρύω	ῡ
ἱδρῦσαι	v--ana---	ἱδρῦω	ῡ
ἱερέαν	n-s---ma-	ἱερέης	ᾱ
ἱεράς	a-p---fa-	ἱερός	ᾱ
ἱερὰς	a-p---fa-	ἱερός	ᾱ
ἱερᾶς	a-p---fa-	ἱερός	ᾱ
ἱερᾶς	a-s---fg-	ἱερός	ᾱ
ἰηλεμιστρίας	n-s---fg-	ἰηλεμιστρία	ᾱ
ἱκεσίας	n-p---fa-	ἱκεσία	ᾱ
ἱκεσία	n-d---fn-	ἱκέσιος	ᾱ
ἱκετᾶν	n-s---fa-	ἱκετᾶ	ᾱ
ἱκέταν	n-s---ma-	ἱκέτης	ᾱ
ἱκτηρίας	n-s---fg-	ἱκτηρία	ᾱ
Ἰλιάδας	n-p---fa-	Ἰλιάς	Αᾱ
Ἰλιάς	n-s---fg-	Ἰλιάς	Ᾱ
Ἰλιὰς	n-s---fg-	Ἰλιάς	Ᾱ
ἱμᾶσιν	n-p---md-	ἱμάς	ᾱ
ἱμᾶσι	n-p---md-	ἱμᾶσι	ᾱ
Ἰναχείας	n-s---fg-	Ἰναχείη	Αᾱ
Ἰνδάς	n-p---fa-	Ἰνδάι	Ᾱ
ἶνινὑμνῆσαι	n-s---fa-	ἶνινὑμνῆσαι	ῑι
Ἰοκάστας	n-p---fa-	Ἰοκάστη	Αᾱ
ἱππευτάν	n-s---ma-	ἱππευτάν	ᾱ
ἱππίαν	n-s---ma-	ἱππίης	ᾱ
ἱππικάς	a-p---fa-	ἱππικός	ᾱ
ἱππικὰς	a-p---fa-	ἱππικός	ᾱ
ἱπποβάτας	n-s---mn-	ἱπποβάτας	αᾱ
ἱπποβότα	n-s---mg-	ἱπποβότα	ᾱ
ἱππονώμας	n-s---mn-	ἱππονώμας	ᾱ
ἱππείας	a-p---fa-	ἱππύς	ᾱ
Ἰσθμίας	a-s---fg-	ἴσθμιος	Ᾱ
Ἰσθμίας	a-p---fa-	ἴσθμιος	Ᾱ
ἴσας	a-p---fa-	ἴσος	ᾱ
ἰσώσας	v-sapamn-	ἰσόω	ᾱ
ἱστᾶσα	v-sppafn-	ἱστᾶσα	ᾱα
στάς	v-sapamn-	ἵστημι	ᾱ
Στάς	v-sapamn-	ἵστημι	Ᾱ
στὰς	v-sapamn-	ἵστημι	ᾱ
Στὰς	v-sapamn-	ἵστημι	Ᾱ
στήσας	v-sapamn-	ἵστημι	ᾱ
ἰσχῦον	v-sppana-	ἰσχύω	ῡ
ἰχθῦς	n-p---ma-	ἰχθύς	ῡ
Ἰωλκίας	n-s---fg-	Ἰωλκία	Ᾱ
Ἰωλκίας	a-s---fg-	Ἰωλκῖος	Ᾱ
ἰώμελέα	a-s---mv-	ἰώμελέα	ᾱ
κάββας	v-sapamn-	κάββης	αᾱ
κἀγορᾶς	n-p---fa-	κἀγορᾶ	αᾱ
κἀγορᾶς	a-s---mn-	κἀγορᾶς	αᾱ
Καδμειᾶν	a-s---fa-	Καδμειᾶν	Αᾱ
Καδμείας	a-s---fg-	Καδμείας	Αᾱ
Καδμείας	a-s---fg-	Καδμεῖος	Αᾱ
Καδμείας	a-p---fa-	Καδμεῖος	Αᾱ
καθαγνίσας	v-sapamn-	καθαγνίσας	ααᾱ
καθαιμάξας	v-sapamn-	καθαιμάσσω	ααᾱ
καθαρᾶν	a-s---fa-	καθαρᾶν	ααᾱ
καθαρμόσας	v-sapamn-	καθαρμόζω	ααᾱ
καθαράς	a-p---fa-	καθαρός	ααᾱ
καθαρὰς	a-p---fa-	καθαρός	ααᾱ
καθαρπάσας	v-sapamn-	καθαρπάζω	αααᾱ
καθεστᾶσιν	v3ppia---	καθεστᾶμι	αᾱ
καταστάς	v-sapamn-	καθίστημι	ααᾱ
καταστὰς	v-sapamn-	καθίστημι	ααᾱ
καθορᾶν	v--pna---	καθοράω	αᾱ
καθυβρίσας	v-sapamn-	καθυβρίσας	αᾱ
καινάς	a-p---fa-	καινάς	ᾱ
καινάς	a-p---fa-	καινός	ᾱ
καινὰς	a-p---fa-	καινός	ᾱ
καιρίας	a-s---fg-	καιρίας	ᾱ
κακᾷ	a-p---na-	κακᾷ	αᾱ
Κακᾷ	a-p---na-	Κακᾷ	Αᾱ
κακανδρίᾳ	n-s---fa-	κακανδρίᾳ	ααᾱ
κἀκβολάς	n-p---fa-	κἀκβολή	αᾱ
κἀκβολὰς	n-p---fa-	κἀκβολή	αᾱ
κακάς	a-p---fa-	κακός	αᾱ
Κακάς	a-p---fa-	κακός	Αᾱ
κακὰς	a-p---fa-	κακός	αᾱ
Κακὰς	a-p---fa-	κακός	Αᾱ
κἀκούσας	v-sapamn-	κἀκούδω	αᾱ
κακουχίᾳ	n-s---fd-	κακουχίη	αᾱ
καλαμοεςσᾶν	n-p---fn-	καλαμος	ααᾱ
καλλιβόας	n-s---mn-	καλλιβόας	αᾱ
καλλονᾶς	n-p---fa-	καλλονᾶς	αᾱ
καλλοσύνας	n-p---fa-	καλλοσύνη	αᾱ
καλλοσύνας	n-s---fg-	καλλοσύνη	αᾱ
καλάς	a-p---fa-	καλός	αᾱ
καλάς	a-p---fa-	καλός	αᾱ
καλὰς	a-p---fa-	καλός	αᾱ
καλλίστας	a-s---fgs	καλός	αᾱ
καλύπτρᾳ	n-p---na-	κάλυπτρα	αᾱ
καλύπτρας	n-p---fa-	καλύπτρη	αᾱ
καλύψας	v-sapamn-	καλύπτω	αᾱ
Κάλχας	n-s---mn-	κάλχας	Αᾱ
κἀμάς	a-p---fa-	κἀμός	αᾱ
κἀμὰς	a-p---fa-	κἀμός	αᾱ
κάμψας	v-sapamn-	κάμπτω	αᾱ
κανᾶ	c--------	κανά	αᾱ
κανᾶ	n-p---na-	κανά	αᾱ
κανᾶ	a-p---na-	κανά	αᾱ
κἀνακωκύσας	v-sapamn-	κἀνακωκύζω	ααᾱ
κἀνακωκύσας	v-sapamn-	κἀνακωκύω	ααᾱ
κἀντιβάς	n-p---fa-	κἀντιβή	αᾱ
Καπανέα	v2spma---	Καπανέα	Ααᾱ
κἀπιβοᾶται	n-p---mn-	κἀπιβοᾶτης	αᾱ
κἀπιδαυρίας	a-s---fg-	κἀπιδαυρῖος	αᾱ
κἀπικουρίας	n-s---fg-	κἀπικουρῖα	αᾱ
κἀπικωκῦσαι	v--ana---	κἀπικωκῦω	ῡ
κἀποβᾶσα	v-sapafn-	κἀποβαίνω	αᾱα
κἀπονοσφίσας	v-sapamn-	κἀπονοσφίζω	αᾱ
κάρᾳ	n-s---nd-	κάρα	αᾱ
κάρᾳ	n-s---na-	κάρα	αᾱ
κάρᾳ	u--------	κάρᾳ	αᾱ
καρβᾶνα	a-s---fa-	καρβάν	αᾱα
καρδίᾳ	n-s---fd-	καρδία	αᾱ
καρδίας	n-s---fg-	καρδία	αᾱ
καρῦξαι	v--ana---	καρῦζω	ῡ
Καρυστίας	a-s---fg-	Καρυστία	Αᾱ
καρφυράς	a-p---fa-	καρφυρός	αᾱ
καρφυρὰς	a-p---fa-	καρφυρός	αᾱ
κασιγνήτας	n-p---fa-	κασιγνήτης	αᾱ
Κασσάνδρας	n-s---fg-	Κασσάνδρα	Ααᾱ
Κασταλίας	n-p---fa-	κασταλία	Ααᾱ
Κασταλίας	n-s---fg-	κασταλία	Ααᾱ
καταβᾶσα	v-sapafn-	καταβᾶσα	ααᾱα
κατᾶξαι	v--ana---	κατᾶγω	αᾱ
καταισχῦναι	v--pna---	καταισχύνω	ῡ
κατάκρας	n-p---fa-	κατάκρη	ααᾱ
κατάκτας	v-sapamn-	κατάκτας	ααᾱ
κατακτάς	v-sapamn-	κατακτείνω	ααᾱ
κατακτάς	v-sapamn-	κατακτείνω	ααᾱ
κατακτὰς	v-sapamn-	κατακτείνω	ααᾱ
κατακτείνας	v-sapamn-	κατακτείνω	ααᾱ
καταλγήσας	v-sapamn-	καταλγέω	ααᾱ
καταπαύσας	v-sapamn-	καταπαύω	ααᾱ
κατάρας	n-p---fa-	κατάρα	ααᾱ
καταρράψας	v-sapamn-	καταρράπτω	αααᾱ
κατασκαφάς	n-p---fa-	κατασκαφή	αααᾱ
κατασκαφάς	n-p---fa-	κατασκαφή	αααᾱ
κατασκαφὰς	n-p---fa-	κατασκαφή	αααᾱ
κατασπείρας	v-sapamn-	κατασπείρω	ααᾱ
κατάστας	v-sapamn-	κατάστας	ααᾱ
καταύδα	v2spma---	καταύδα	αᾱ
καταυχήσας	v-sapamn-	καταυχέω	αᾱ
καταφθίσας	v-sapamn-	καταφθίζω	ααᾱ
καταφυγάς	n-p---fa-	καταφυγή	ααᾱ
καταφυγὰς	n-p---fa-	καταφυγή	ααᾱ
κατηναρισμένας	v-prpefa-	κατεναρίζω	ααᾱ
κατερρώγασιν	v3pria---	κατερρώγασιν	αᾱ
κατεσβήκασιν	v3pria---	κατεσβήκασιν	αᾱ
καταστάς	v-sapamn-	κατίστημι	ααᾱ
κατόπτας	n-p---fa-	κατόπτη	αᾱ
κατορθώσας	v-sapamn-	κατορθώζω	αᾱ
κατωικήκασιν	v3pria---	κατωικήκασιν	αᾱ
κἀφαγιστεύσας	v-sapamn-	κἀφαγιστεύω	ααᾱ
κεδνάς	a-p---fa-	κεδνός	ᾱ
κεδνὰς	a-p---fa-	κεδνός	ᾱ
κείνας	a-p---fa-	κείνας	ᾱ
Κεκροπίας	n-p---fa-	Κεκροπῖα	Ᾱ
Κεκροπίας	n-p---fa-	Κεκροπίη	Ᾱ
κεκρυμμένας	v-prpefa-	κεκρυμμένας	ᾱ
κελαινώπαν	a-s---ma-	κελαινώπας	ᾱ
κελεύσας	v-sapamn-	κελεύω	ᾱ
κέλσας	v-sapamn-	κέλω	ᾱ
κενάς	a-p---fa-	κενάς	ᾱ
κενάς	a-p---fa-	κενός	ᾱ
κενάς	a-p---fa-	κενός	ᾱ
κενὰς	a-p---fa-	κενός	ᾱ
κενώσας	v-sapamn-	κενόω	ᾱ
κεραϊζομένας	v-pppefa-	κεραϊζομένας	αᾱ
κέρας	n-s---nn-	κέρας	ᾱ
κέρας	n-s---na-	κέρας	ᾱ
κεραυνίᾳ	a-s---fd-	κεραυνίᾳ	ᾱ
κεραυνίας	a-s---fg-	κεραυνίη	ᾱ
κεραυνίᾳ	a-s---fd-	κεραύνιος	ᾱ
κερκίδας	n-s---fg-	κερκίδα	ᾱ
Κερχνείας	n-s---fg-	Κερχνείη	Ᾱ
κεφαλά	n-d---fn-	κεφαλάς	αᾱ
κεφαλάς	n-p---fa-	κεφαλή	αᾱ
κεφαλὰς	n-p---fa-	κεφαλή	αᾱ
κεφαλᾶς	n-p---fa-	κεφαλή	αᾱ
κεχειρωμένας	v-prpefa-	κεχειρωμένας	ᾱ
κηδείας	n-s---fg-	κηδεία	ᾱ
κηδεύσας	v-sapamn-	κηδεύω	ᾱ
κηρύξας	v-sapamn-	κηρύσσω	ᾱ
κιθάρας	n-s---fg-	κιθάρα	αᾱ
κισσώσας	v-sapamn-	κισσόω	ᾱ
κλάδας	n-p---fa-	κλά	αᾱ
κλαγγᾷ	n-s---fd-	κλαγγή	αᾱ
κλεινάς	a-p---fa-	κλεινός	ᾱ
κλεινάς	a-p---fa-	κλεινός	ᾱ
κλεινὰς	a-p---fa-	κλεινός	ᾱ
κλέψας	v-sapamn-	κλέπτω	ᾱ
κλέψας	v-sapamn-	κλέφω	ᾱ
κληδόνας	n-p---fa-	κληδόνας	ᾱ
κληδόνας	n-p---fa-	κληδών	ᾱ
κλαιομένας	v-sppefg-	κλήιω	ᾱ
κλισίας	n-p---fa-	κλισία	ᾱ
κλισίας	n-s---fg-	κλισία	ᾱ
κλοπάς	n-p---fa-	κλοπή	ᾱ
κλοπὰς	n-p---fa-	κλοπή	ᾱ
κλυούσᾳ	v-sppafn-	κλυούσᾳ	ᾱ
Κλυταιμήστρᾳ	n-s---fd-	Κλυταιμήστρα	Ᾱ
Κλυταιμήστρας	n-s---fg-	Κλυταιμήστρα	Ᾱ
Κλυταιμήστρας	n-s---fg-	Κλυταιμήστρας	Ᾱ
Κλυταιμήστρας	n-s---fg-	Κλυταιμήστρη	Ᾱ
κλυτᾶς	a-s---fg-	κλυτός	ᾱ
κλωπικάς	a-p---fa-	κλωπικὰ	ᾱ
κλωπικὰς	a-p---fa-	κλωπικὰ	ᾱ
κνέφας	n-s---nn-	κνέφας	ᾱ
κνέφας	n-s---na-	κνέφας	ᾱ
κνισᾶν	v3paia---	κνισᾶν	ᾱ
κοίτας	a-s---fg-	κοί	ᾱ
κοίλας	a-p---fa-	κοῖλος	ᾱ
κοινάς	a-p---fa-	κοινός	ᾱ
κοινάς	a-p---fa-	κοινός	ᾱ
κοινάς	a-s---fg-	κοινός	ᾱ
κοινὰς	a-p---fa-	κοινός	ᾱ
κοινὰς	a-s---fg-	κοινός	ᾱ
κοινώσας	v-sapamn-	κοινόω	ᾱ
κοῖταιπατρίας	n-p---fa-	κοῖταιπατρία	αᾱ
κοίτας	n-p---fa-	κοίτη	ᾱ
κόμας	n-p---fa-	κόμη	ᾱ
κονίσας	v-sapamn-	κονίζω	ᾱ
κόρας	n-p---fa-	κόρας	ᾱ
κόρσας	v-sapamn-	κόρζω	ᾱ
κόρας	n-s---fg-	κόρη	ᾱ
κόρας	n-p---fa-	κόρη	ᾱ
κούρας	n-p---fa-	κόρη	ᾱ
Κόρας	n-s---fg-	Κόρη	Ᾱ
κόραν	n-s---ma-	κόρης	ᾱ
Κορινθίας	n-s---fg-	Κορινθία	Ᾱ
Κορινθίας	a-s---fg-	Κορινθία	Ᾱ
Κορινθίας	a-s---fg-	Κορινθῖος	Ᾱ
κορυφᾶς	n-p---fa-	κορυφᾶς	ᾱ
κορυφάς	n-p---fa-	κορυφή	ᾱ
κορυφὰς	n-p---fa-	κορυφή	ᾱ
κοσμήσας	v-sapamn-	κοσμέω	ᾱ
κούφας	a-p---fa-	κούφας	ᾱ
κουφίσας	v-sapamn-	κουφίζω	ᾱ
κραδίας	n-s---fg-	κραδία	αᾱ
κραδίᾳ	n-p---nn-	κραδίᾳ	αᾱ
κραταιᾶς	a-s---fg-	κραταιός	αᾱ
κρατήσας	v-sapamn-	κρατέω	αᾱ
κρήνας	n-p---fa-	κρήνη	ᾱ
Κρησίας	n-p---fa-	Κρησία	Ᾱ
Κρήσσας	n-p---fa-	Κρήσση	Ᾱ
κριμναμενᾶν	v-sapafa-	κριμναμενᾶν	αᾱ
κρίνας	v-sapamn-	κρίνω	ᾱ
Κρονίδαν	n-s---ma-	Κρονίδας	Ᾱ
Κρονίδας	n-s---mn-	Κρονίδας	Ᾱ
Κρονίδας	n-s---mn-	κρονίδης	Ᾱ
κρυπτᾷ	a-p---na-	κρυπτᾷ	ᾱ
κρυπτᾶι	a-p---fn-	κρυπτᾶι	ᾱ
κρύψας	v-sapamn-	κρύπτω	ᾱ
κτείνας	v-sapamn-	κτείνω	ᾱ
κτένας	n-p---fa-	κτένη	ᾱ
κτίσας	v-sapamn-	κτίζω	ᾱ
κτίσσας	v-sapamn-	κτίζω	ᾱ
κυανέας	a-p---fa-	κυανέ	αᾱ
κυανεᾶν	a-s---fa-	κυανεᾶν	αᾱ
κυανέας	a-s---fg-	κυανέας	αᾱ
κυανέας	a-p---fa-	κυανέος	αᾱ
Κυβέλας	n-p---fa-	Κυβέλη	Ᾱ
κυκάτω	v3spma---	κυκαίνω	ᾱ
Κυκλάδας	n-p---fa-	κυκλάδες	Αᾱ
κυκλώσας	v-sapamn-	κυκλώζω	ᾱ
Κυκλωπιᾶν	a-s---fa-	Κυκλωπιᾶ	Ᾱ
Κυκλωπίας	a-s---fg-	Κυκλωπία	Ᾱ
Κυλλανίας	n-p---fg-	Κυλ	Αᾱ
Κυλλάνας	n-s---fg-	κυλλήνη	Αᾱ
κυναγίας	n-s---fg-	κυναγία	αᾱ
κυναγίᾳ	n-s---fd-	κυνηγία	αᾱ
Κυπρίας	n-p---fa-	Κυπρίας	Ᾱ
κυρήσας	v-sapamn-	κυρέω	ᾱ
κύρσας	v-sapamn-	κυρέω	ᾱ
κυρήσας	v-sapamn-	κυρήσας	ᾱ
Κυχρείας	a-p---fa-	Κυχρύς	Ᾱ
κύνας	n-p---fa-	κύων	ᾱ
κώπας	n-p---fa-	κώπας	ᾱ
κώπας	n-p---fa-	κώπη	ᾱ
Λαβδακιδᾶν	n-p---mg-	Λαβδακίδης	Ααᾱ
λαβάς	n-p---fa-	λαβή	αᾱ
λαβὰς	n-p---fa-	λαβή	αᾱ
λαγοδαίτας	n-p---fa-	λαγοδαίται	αᾱ
λαγόνας	n-p---fa-	λαγόνη	αᾱ
λάθρᾳ	d--------	λάθρῃ	αᾱ
Λάθρᾳ	d--------	λάθρῃ	Αᾱ
λαΐνας	n-p---fa-	λαΐνη	αᾱ
λακτίσας	v-sapamn-	λακτίζω	αᾱ
λαμπάδας	n-p---fa-	λαμπάς	ααᾱ
λάμπᾳ	n-s---fd-	λάμπᾳς	αᾱ
λαμπρᾶς	a-p---fa-	λαμπρός	αᾱ
λαμπρᾶς	a-s---fg-	λαμπρός	αᾱ
λαμπτηρουχίας	a-p---fa-	λαμπτηρουχίη	αᾱ
λάμψας	v-sapamn-	λάμψας	αᾱ
λαοδάμας	n-s---mn-	λαοδάμας	ααᾱ
Λαρτιάδας	n-s---mn-	Λαρτιάδης	Ααᾱ
λατρείας	n-s---fg-	λατρεία	αᾱ
λατρείας	n-p---fa-	λατρεία	αᾱ
λεαίνας	n-s---fg-	λεαίνη	ᾱ
λέξας	v-sapamn-	λέγω	ᾱ
λείας	n-p---fa-	λεία	ᾱ
λείας	n-s---fg-	λεία	ᾱ
λειμωνίας	a-p---fa-	λειμωνῖος	ᾱ
λελειμμένα	v-drpefn-	λείπω	ᾱ
λέξας	v-sapamn-	λέξας	ᾱ
λεοντοφυᾶ	n-s---fa-	λεοντοφυᾶ	ᾱ
λεπαίας	n-p---fa-	λεπαίη	ᾱ
λέπας	a-p---fa-	λέπη	ᾱ
λέπας	n-p---fa-	λέπη	ᾱ
Λερναίας	a-s---fg-	λερναῖος	Ᾱ
Λέρνας	n-s---fg-	Λέρνη	Ᾱ
λέσχας	n-p---fa-	λέσχη	ᾱ
Λευκιππίδας	n-p---fa-	Λευκιππίδη	Ᾱ
Λευκοθέας	n-s---fg-	Λευκοθέη	Ᾱ
λευκολόφας	n-s---mn-	λευκολόφης	ᾱ
λευκάς	a-p---fa-	λευκός	ᾱ
λευκὰς	a-p---fa-	λευκός	ᾱ
λήξας	v-sapamn-	λήγω	ᾱ
Λήδας	n-p---fa-	Λήδαι	Ᾱ
Λήδαν	n-s---ma-	Λήδαν	Ᾱ
Λήδας	n-s---fg-	Λήδας	Ᾱ
Λήδας	n-p---fa-	Λήδη	Ᾱ
Λήδας	n-s---fg-	Λήδη	Ᾱ
Λήδας	n-s---fg-	Λής	Ᾱ
Λήδας	n-p---fa-	Λής	Ᾱ
Λίμνας	n-s---fg-	Λί	Ᾱ
λιβάς	n-s---mn-	λιβάς	ᾱ
λιβὰς	n-s---mn-	λιβὰς	ᾱ
Λιβυσσᾶν	v3paia---	Λιβυσσᾶν	Ᾱ
λιγείας	a-s---fg-	λιγεῖος	ᾱ
λιγυρᾷ	a-s---fd-	λιγυρός	ᾱ
λιθάς	n-p---fa-	λιθή	ᾱ
λιθὰς	n-p---fa-	λιθή	ᾱ
λίμνᾳ	n-s---fd-	λίμνη	ᾱ
λίμνας	n-p---fa-	λίμνη	ᾱ
Λίμνας	n-p---fa-	λίμνη	Ᾱ
λισσάς	n-s---fg-	λισσάς	ᾱ
λισσὰς	n-s---fg-	λισσὰς	ᾱ
λιτάς	n-p---fa-	λιτάς	ᾱ
λιτάς	n-p---fa-	λιτή	ᾱ
λιτάς	n-p---fa-	λιτή	ᾱ
λιτὰς	n-p---fa-	λιτή	ᾱ
Λίχαν	n-s---ma-	Λίχανς	Ᾱ
Λίχα	n-s---mv-	λίχας	Ᾱ
Λίχας	n-s---mn-	λίχας	Ᾱ
λόγχας	n-p---fa-	λόγχη	ᾱ
λόγχας	n-s---fg-	λόγχη	ᾱ
λοιβάς	n-p---fa-	λοιβά	ᾱ
λοιβὰς	n-p---fa-	λοιβά	ᾱ
λοιβάς	n-p---fa-	λοιβάς	ᾱ
λοιβὰς	n-p---fa-	λοιβὰς	ᾱ
λομένας	v-pppefa-	λομένας	ᾱ
Λοξία	n-s---mv-	Λοξία	Ᾱ
Λοξίᾳ	n-s---mg-	Λοξίᾳ	Ᾱ
Λοξίας	n-s---mn-	λοξίας	Ᾱ
Λοξία	n-s---mv-	Λοξίας	Ᾱ
Λοξίαν	n-s---ma-	Λοξίας	Ᾱ
Λοξίας	n-s---mn-	Λοξίας	Ᾱ
λοχαγέτας	n-p---fa-	λοχαγέτη	αᾱ
λοχαίας	n-p---fa-	λοχαίη	ᾱ
λοχείας	n-p---fa-	λοχεία	ᾱ
λοχιᾶν	a-s---fa-	λοχιᾶν	ᾱ
λυγαίας	a-s---fg-	λυγαῖος	ᾱ
λυγράς	a-p---fa-	λυγρός	ᾱ
λυγρᾶς	a-s---fg-	λυγρός	ᾱ
Λυδίας	n-s---fg-	Λυδία	Ᾱ
Λυκίας	n-s---fg-	λυκία	Ᾱ
λύμᾳ	n-s---na-	λύμᾳ	ᾱ
λύμας	n-p---fa-	λύμη	ᾱ
λύπᾳ	a-p---na-	λύπᾳ	ᾱ
λύπας	n-p---fa-	λύπας	ᾱ
λύπας	n-p---fa-	λύπη	ᾱ
λύρας	n-s---fg-	λύρα	ᾱ
λύσσας	n-s---fg-	λύσσα	ᾱ
λύσσας	n-p---fa-	λύσσα	ᾱ
Λύσσας	n-s---fg-	Λύσση	Ᾱ
λύσας	v-sapamn-	λύω	ᾱ
λώβας	n-p---fa-	λώβη	ᾱ
Μαίας	n-p---fa-	μαῖα	Ᾱ
Μαίας	n-s---fg-	μαῖα	Ᾱ
μαινάδας	n-p---fa-	μαινάδαι	αᾱ
μαινάδας	n-p---fa-	μαινάδας	αᾱ
μαινάδας	n-p---fa-	μαινάς	αᾱ
μαινάς	n-p---fa-	μαινάς	ᾱ
μαινάς	n-s---fg-	μαινάς	ᾱ
μαινὰς	n-p---fa-	μαινάς	ᾱ
μαινὰς	n-s---fg-	μαινάς	ᾱ
μακαριωτάτας	a-p---fa-	μακαρειός	αααᾱ
μακαρίας	a-s---fg-	μακαρίας	ααᾱ
μακαρίτας	n-s---mn-	μακαρίτης	ααᾱ
μακρᾶι	a-p---fd-	μακρᾶι	αᾱ
μακράς	a-s---fg-	μακρός	αᾱ
Μακράς	a-p---fa-	μακρός	Αᾱ
Μακράς	a-s---fg-	μακρός	Αᾱ
μακρὰς	a-s---fg-	μακρός	αᾱ
Μακρὰς	a-p---fa-	μακρός	Αᾱ
Μακρὰς	a-s---fg-	μακρός	Αᾱ
μακρᾶς	a-p---fa-	μακρός	αᾱ
μακρᾶς	a-s---fg-	μακρός	αᾱ
μανιάς	n-s---fg-	μανιά	αᾱ
μανιᾶν	n-s---fa-	μανιᾶ	αᾱ
μανίᾳ	n-s---fd-	μανία	αᾱ
μανίας	n-s---fg-	μανία	αᾱ
μαντείας	n-s---fg-	μαντεία	αᾱ
μαντείας	n-p---fa-	μαντεία	αᾱ
μαντείᾳ	a-s---fd-	μαντεῖος	αᾱ
μαρᾶναι	v--ana---	μαρᾶναι	αᾱ
μάρψας	v-sapamn-	μάρπτω	αᾱ
Μασίστρας	n-s---mn-	Μασίστρας	Αᾱ
ματᾴζει	v3spia---	ματᾴ	αᾱ
Ματᾶν	n-s---ma-	Ματᾶ	Αᾱ
ματᾷ	n-p---na-	ματᾷ	αᾱ
ματᾷ	p-p---na-	ματᾷ	αᾱ
μάταν	n-s---ma-	μάτα	αᾱ
ματᾴζων	v-sppamn-	ματᾴζω	αᾱ
ματαίᾳ	a-s---fd-	ματαίᾳ	αᾱ
ματαίᾳ	a-s---fn-	ματαῖος	αᾱ
ματαίας	a-s---fg-	ματαῖος	αᾱ
ματᾶν	v--pna---	ματάω	αᾱ
ματέρας	n-p---fa-	ματέρη	αᾱ
μαχανᾷ	n-p---na-	μαχανᾷ	ααᾱ
μάχᾳ	n-s---fd-	μάχη	αᾱ
μάχας	n-p---fa-	μάχη	αᾱ
μαχουμένα	v-dppefn-	μαχουμένα	αᾱ
Μεγαβάτα	n-s---mg-	Μεγαβάτης	Ααᾱ
μέγαν	a-s---ma-	μέγαν	ᾱ
Μεγάρας	n-s---fg-	Μεγάρη	Αᾱ
μεγάλα	a-d---fn-	μέγας	αᾱ
μεγάλας	a-p---fa-	μέγας	αᾱ
μέγαν	a-s---ma-	μέγας	ᾱ
μέγας	a-s---mn-	μέγας	ᾱ
Μέγας	a-s---mn-	μέγας	Ᾱ
μεγίστας	a-p---fas	μέγας	ᾱ
μεγίστας	a-p---fa-	μέγας	ᾱ
μεγάλᾳ	a-p---na-	μέγᾳς	αᾱ
μεγίστᾳ	a-p---na-	μεγίστᾳ	ᾱ
μεταστάς	v-sapamn-	μεθίστημι	αᾱ
μεταστὰς	v-sapamn-	μεθίστημι	αᾱ
μέλας	a-s---mn-	μέλας	ᾱ
μελέας	a-p---fa-	μελέη	ᾱ
μελέας	a-s---fg-	μελέος	ᾱ
μελισσᾶν	n-s---fa-	μέλισσα	ᾱ
μελισσᾶν	n-p---fg-	μέλισσα	ᾱ
μελιςσᾶν	n-s---fa-	μελιςτον	ᾱ
μελλούσας	v-pppafa-	μέλλω	ᾱ
μελωιδίας	n-s---fg-	μελωιδεία	ᾱ
Μενέλας	n-s---mn-	Μενέλας	Ᾱ
Μενέλα	n-s---mg-	Μενέλης	Ᾱ
μείνας	v-sapamn-	μένω	ᾱ
μερίμνας	n-p---fa-	μέριμνα	ᾱ
μερίμνας	n-s---fg-	μέριμνα	ᾱ
μέσας	a-p---fa-	μέσος	ᾱ
μεταβάς	v-sapamn-	μεταβαίνω	αᾱ
μεταβὰς	v-sapamn-	μεταβαίνω	αᾱ
μεταβολάς	n-p---fa-	μεταβολή	αᾱ
μεταβολάς	n-p---fa-	μεταβολή	αᾱ
μεταβολὰς	n-p---fa-	μεταβολή	αᾱ
μεταιτίᾳ	a-s---fd-	μεταιτία	ᾱ
μεταλλαγᾷ	v1sria---	μεταλλαγᾷ	ααᾱ
μεταναστάς	v-sapamn-	μεταναστής	ααᾱ
μετασπᾶν	v--pna---	μετασπάω	αᾱ
μεταστάς	v-sapamn-	μετίστημι	αᾱ
μεταστὰς	v-sapamn-	μετίστημι	αᾱ
μετοικίας	n-s---fg-	μετοικία	ᾱ
μετρίας	a-s---fg-	μετρῖος	ᾱ
Μηλιᾶ	n-p---na-	Μηλιᾶ	Ᾱ
μηλονόμας	n-p---fa-	μηλονόμη	ᾱ
μηνίσας	v-sapamn-	μηνίω	ᾱ
μηνύσας	v-sapamn-	μηνύω	ᾱ
μητέρας	n-p---fa-	μήτηρ	ᾱ
μητραλοίαν	n-s---ma-	μητραλοίας	αᾱ
μητρυιάς	n-p---fa-	μητρυιάς	ᾱ
μητρυιὰς	n-p---fa-	μητρυιὰς	ᾱ
μηχανάς	n-p---fa-	μηχανά	αᾱ
μηχανᾶι	v2spie---	μηχανᾶι	αᾱ
μηχανᾶν	v--pna---	μηχανάομαι	αᾱ
μηχανᾶσθαι	v--pne---	μηχανάομαι	αᾱ
μηχανάς	n-p---fa-	μηχανάς	αᾱ
μηχανάς	n-p---fa-	μηχανή	αᾱ
μηχανάς	n-p---fa-	μηχανή	αᾱ
μηχανὰς	n-p---fa-	μηχανή	αᾱ
μιᾶι	a-s---fd-	μιᾶι	ᾱ
μιᾶι	a-p---fd-	μιᾶι	ᾱ
μιᾶι	a-p---fn-	μιᾶι	ᾱ
μιᾶς	u--------	μιᾶς	ᾱ
μικρᾶς	a-s---fg-	μικρός	ᾱ
σμικράς	a-p---fa-	μικρός	ᾱ
σμικρᾶς	a-s---fg-	μικρός	ᾱ
σμικρᾶς	a-p---fa-	μικρός	ᾱ
Μινύας	n-s---mn-	Μινύας	Ᾱ
μοίρας	n-s---fg-	μοῖρα	ᾱ
μοίρας	n-p---fa-	μοῖρα	ᾱ
Μοίρας	n-p---fa-	μοῖρα	Ᾱ
Μοίρας	n-s---fg-	μοῖρα	Ᾱ
Μολοσσίας	n-p---fa-	Μολοσσίη	Ᾱ
μολπάν	n-s---ma-	μολπὰς	ᾱ
μολπὰν	n-s---ma-	μολπὰς	ᾱ
μολπάς	n-p---fa-	μολπή	ᾱ
μολπὰς	n-p---fa-	μολπή	ᾱ
μομφάς	n-p---fa-	μομφή	ᾱ
μομφὰς	n-p---fa-	μομφή	ᾱ
μοναρχίας	n-s---fg-	μοναρχία	αᾱ
μόνα	a-d---fn-	μόνος	ᾱ
μόνας	a-p---fa-	μόνος	ᾱ
μόραν	n-s---ma-	μόρης	ᾱ
μορφάς	n-p---fa-	μορφή	ᾱ
μορφάς	n-p---fa-	μορφή	ᾱ
μορφὰς	n-p---fa-	μορφή	ᾱ
μούσας	n-p---fa-	μοῦσα	ᾱ
μούσας	n-s---fg-	μοῦσα	ᾱ
Μούσας	n-p---fa-	μοῦσα	Ᾱ
μοχθήσας	v-sapamn-	μοχθέω	ᾱ
μυδώσας	v-sapamn-	μυδώω	ᾱ
μυκᾶται	v3spie---	μυκάομαι	ᾱ
Μυκήνας	n-p---fa-	μυκήνη	Ᾱ
μυριάδας	n-p---fa-	μυριάς	αᾱ
μυριάς	a-p---fa-	μυριάς	ᾱ
μυριὰς	a-p---fa-	μυριὰς	ᾱ
μυρίας	a-p---fa-	μυρίος	ᾱ
μυρίας	a-s---fg-	μυρῖος	ᾱ
μυρσίνας	n-p---fa-	μυρσίνη	ᾱ
μυσαρᾶς	n-s---fg-	μυσαρή	αᾱ
μωρίας	n-p---fa-	μωρία	ᾱ
μωρίας	n-s---fg-	μωρία	ᾱ
νᾶεςπανωλέθροισιν	a-p---fd-	νᾶεςπανωλέθροισιν	ᾱα
νάπας	n-p---fa-	νάπα	αᾱ
ναπαίας	n-p---fa-	ναπαίη	αᾱ
νάπας	n-p---fa-	νάπη	αᾱ
ναυαγίας	n-s---fg-	ναυαγία	αᾱ
ναυβατᾶν	n-p---mn-	ναυβατᾶν	αᾱ
ναυβάταν	n-s---ma-	ναυβάτας	αᾱ
ναυβάτας	n-s---mn-	ναυβάτης	αᾱ
ναυκληρίας	n-s---fg-	ναυκληρία	ᾱ
Ναυπακτίας	n-s---fg-	Ναυπακτία	Αᾱ
Ναυπλίας	a-p---fa-	Ναυπλία	Ᾱ
Ναυπλίας	a-s---fg-	Ναυπλῖος	Ᾱ
νέας	n-p---fa-	ναῦς	ᾱ
νέας	a-s---fg-	ναῦς	ᾱ
ναύταν	n-s---ma-	ναύτης	ᾱ
νεανία	n-s---mv-	νεανία	αᾱ
νεανιᾶν	a-s---fa-	νεανιᾶν	αᾱ
νεανίαν	n-s---ma-	νεανίας	αᾱ
νεανίας	n-s---mn-	νεανίας	αᾱ
νεαράς	a-p---fa-	νεαράς	αᾱ
νεαρὰς	a-p---fa-	νεαρὰς	αᾱ
νεαρᾶς	a-p---fa-	νεαρᾶς	αᾱ
νεβρίδας	n-p---fa-	νεβρίδαι	ᾱ
νεβρίδα	n-s---mv-	νεβρίδας	ᾱ
νειφομένας	v-pppefa-	νειφομένας	ᾱ
Νεμέας	n-s---fg-	Νεμέα	Ᾱ
νεότας	n-s---fg-	νεός	ᾱ
νέας	a-s---fg-	νέος	ᾱ
νέας	a-p---fa-	νέος	ᾱ
νεωτέρας	a-s---fgc	νέος	ᾱ
νερτέρας	a-s---fg-	νερτέρας	ᾱ
νερτέρας	a-p---fa-	νερτέρη	ᾱ
νευράς	n-p---fa-	νευράς	ᾱ
νεφέλας	n-p---fa-	νεφέλη	ᾱ
νας	v-pppafa-	νη	ᾱ
ναΐας	a-s---fg-	νήιος	αᾱ
νησαίας	a-p---fa-	νησαίας	ᾱ
νικᾶι	v2spie---	νικᾶι	ᾱ
νικᾶι	v3spsa---	νικᾶι	ᾱ
νικᾶι	v3spia---	νικᾶι	ᾱ
νικᾶις	v2spia---	νικᾶις	ᾱ
νικᾶν	v--pna---	νικᾶν	ᾱ
νικᾶσθαι	v--pne---	νικάομαι	ᾱ
νικᾶτε	v2ppma---	νικᾶτέ	ᾱ
ἐνίκα	v3siia---	νικάω	ᾱ
νικᾷ	v3spia---	νικάω	ᾱ
νικᾷ	v3spsa---	νικάω	ᾱ
Νικᾷ	v3spia---	νικάω	Ᾱ
νίκα	v2spma---	νικάω	ᾱ
νικᾶν	v--pna---	νικάω	ᾱ
Νικᾶν	v--pna---	νικάω	Ᾱ
νικᾶτε	v2ppma---	νικάω	ᾱ
νικάτω	v3spma---	νικάω	ᾱ
νικήσας	v-sapamn-	νικάω	ᾱ
Νιόβα	n-s---mv-	Νιόβας	Ᾱ
νοήσας	v-sapamn-	νοέω	ᾱ
νομάς	n-p---fa-	νομάι	ᾱ
νομάδας	n-p---fa-	νομάς	αᾱ
νομίσας	v-sapamn-	νομίζω	ᾱ
νοσήσας	v-sapamn-	νοσέω	ᾱ
νοσηλείας	n-s---fg-	νοσηλείας	ᾱ
νοστήσας	v-sapamn-	νοστέω	ᾱ
νοσφίσας	v-sapamn-	νοσφίζω	ᾱ
Νυμφαίας	a-p---fa-	Νυμφαῖος	Ᾱ
νύμφαν	n-s---ma-	νύμφαν	ᾱ
νυμφεύσας	v-sapamn-	νυμφεύω	ᾱ
νυμφᾶν	n-s---fa-	νύμφη	ᾱ
Νυμφᾶν	n-p---fg-	νύμφη	Ᾱ
Νυμφᾶν	n-s---ma-	νύμφη	Ᾱ
Νυμφᾶν	n-p---fn-	νύμφη	Ᾱ
νύμφας	n-s---fg-	νύμφη	ᾱ
νύμφας	n-p---fa-	νύμφη	ᾱ
Νύμφας	n-p---fa-	νύμφη	Ᾱ
νυμφικάς	n-p---fa-	νυμφικάς	ᾱ
νυμφικάς	n-p---fa-	νυμφικάς	ᾱ
νυμφικὰς	n-p---fa-	νυμφικὰς	ᾱ
νύκτας	n-p---fa-	νύξ	ᾱ
Νύσας	v-pppafa-	Νύσας	Ᾱ
ἐνώμα	v3siia---	νωμάω	ᾱ
ξανθᾶι	a-p---fn-	ξανθᾶι	αᾱ
ξανθάς	a-p---fa-	ξανθός	αᾱ
ξανθὰς	a-p---fa-	ξανθός	αᾱ
ξένας	n-p---fa-	ξέ	ᾱ
ξεινοδαΐκταν	a-s---ma-	ξεινοδαΐκτης	αᾱ
ξενίας	n-p---fa-	ξενία	ᾱ
ξενίας	n-s---fg-	ξενία	ᾱ
ξένας	a-s---fg-	ξένος	ᾱ
ξένας	a-p---fa-	ξένος	ᾱ
ξυμβεβᾶσι	v3pria---	ξυμβεβᾶσί	ᾱ
Ξύμπας	a-s---mn-	Ξύμπας	Ᾱ
ξυμπερᾶναι	v--ana---	ξυμπεραίνω	ᾱ
ξυμπολῖται	n-p---fv-	ξυμπολῖτος	ῑ
ξυμφοράς	n-p---fa-	ξυμφορά	ᾱ
ξυμφορὰς	n-p---fa-	ξυμφορά	ᾱ
ξυμφορᾶς	a-s---fg-	ξυμφορά	ᾱ
ξυμφορᾶς	n-s---fg-	ξυμφορά	ᾱ
ξυμφορᾶι	n-p---fn-	ξυμφορᾶ	ᾱ
ξυμφορᾶς	n-s---fg-	ξυμφορᾶ	ᾱ
ξυμφορᾷ	n-s---fd-	ξυμφορᾷ	ᾱ
ξυμφορᾷ	n-p---na-	ξυμφορᾷ	ᾱ
ξυμφορᾷ	a-p---na-	ξυμφορᾷ	ᾱ
ξυμφοράς	n-p---fa-	ξυμφοράς	ᾱ
ξυμφορὰς	n-p---fa-	ξυμφορὰς	ᾱ
ξυμφορᾶι	n-p---fn-	ξυμφορᾶς	ᾱ
ξυμφορᾶς	n-p---fa-	ξυμφορᾶς	ᾱ
ξυμφορᾶς	n-s---fg-	ξυμφορᾶς	ᾱ
Ξυμφορᾶς	n-s---fg-	Ξυμφορή	Ᾱ
ξυνάψας	v-sapamn-	ξυνάπτω	αᾱ
ξυναρτήσας	v-sapamn-	ξυναρτέω	αᾱ
ξυνασχαλᾷ	v3spia---	ξυνασχαλάω	ααᾱ
ξυνεισβάς	v-sapamn-	ξυνεισβαίνω	ᾱ
ξυνεισβὰς	v-sapamn-	ξυνεισβαίνω	ᾱ
ξυνουσίᾳ	a-p---na-	ξυνουσίᾳ	ᾱ
ξυνουσίας	n-s---fg-	ξυνουσίας	ᾱ
ξυνουσίᾳ	a-s---fd-	ξυνουσῖος	ᾱ
ξυνωρίδας	n-p---fa-	ξυνωρίς	ᾱ
ξυστᾶσ’	v-sapafn-	ξυστᾶσ	ᾱ
Ὄγκας	n-p---fa-	Ὄγκη	Ᾱ
ὀδοντοφυᾶ	a-s---fa-	ὀδοντοφυᾶ	ᾱ
ὀδυνᾶι	v2spie---	ὀδυνᾶι	ᾱ
ὀδυνᾶν	v1saia---	ὀδυνάω	ᾱ
ὀδύνας	n-s---fg-	ὀδύνη	ᾱ
ὀδύνας	n-p---fa-	ὀδύνη	ᾱ
ἴσασι	v3pria---	οἶδα	ᾱ
ἴσασιν	v3pria---	οἶδα	ᾱ
Οἰδιπόδα	n-s---mg-	Οἰδιπόδα	Ᾱ
Οἰδιπόδα	n-s---mg-	οἰδιπόδης	Ᾱ
Οἰδιπόδαν	n-s---ma-	Οἰδιπόδης	Ᾱ
Οἰδιπόδα	n-s---mv-	οἰδίπους	Ᾱ
οἰκείας	a-s---fg-	οἰκεῖος	ᾱ
οἰκείας	a-p---fa-	οἰκεῖος	ᾱ
οἰκουμένας	v-pppefa-	οἰκεύω	ᾱ
οἰκήσας	v-sapamn-	οἰκέω	ᾱ
οἰκίας	n-p---fa-	οἰκία	ᾱ
οἰκουρίας	a-s---fg-	οἰκουρία	ᾱ
οἰκτίρας	v-sapamn-	οἰκτείρω	ᾱ
οἰκτίσας	v-sapamn-	οἰκτίζω	ᾱ
οἰκτράς	a-p---fa-	οἰκτρός	ᾱ
οἰμωγάς	n-p---fa-	οἰμωγή	ᾱ
οἰμωγὰς	n-p---fa-	οἰμωγή	ᾱ
οἰμώξας	v-sapamn-	οἰμώζω	ᾱ
οἰνάνθας	n-p---fa-	οἰνάνθη	αᾱ
οἴνας	n-s---fg-	οἴνη	ᾱ
οἰνηράς	a-p---fa-	οἰνηρός	ᾱ
οἰνηρὰς	a-p---fa-	οἰνηρός	ᾱ
Οἰνιαδᾶν	n-p---mg-	οἰνιάδαι	Αᾱ
οἰνοδόταν	n-s---ma-	οἰνοδότα	ᾱ
Οἰνωᾶτιν	n-s---ma-	Οἰνωᾶτις	Ᾱ
οἰοβώτας	n-s---mn-	οἰοβώτας	ᾱ
οἵας	n-p---fa-	οἷος	ᾱ
οἵας	a-s---fg-	οἷος	ᾱ
οἵας	a-p---fa-	οἷος	ᾱ
οἴξας	v-sapamn-	οἴσσω	ᾱ
οἰστρήσας	v-sapamn-	οἰστράω	ᾱ
Οἴτας	n-p---fa-	Οἴτη	Ᾱ
Οἰχαλίας	n-s---fg-	Οἰχαλία	Αᾱ
οἰχομένας	v-sppefg-	οἰχομένας	ᾱ
οἰχομένας	v-pppefa-	οἰχομένας	ᾱ
οἰωνοθέτας	n-s---mn-	οἰωνοθέτης	ᾱ
ὀκλάσας	v-sapamn-	ὀκλάω	αᾱ
ὀλβίσας	v-sapamn-	ὀλβίζω	ᾱ
ὀλβίας	a-s---fg-	ὀλβῖος	ᾱ
ὀλβοδόταν	n-s---ma-	ὀλβοδότης	ᾱ
ὀλέσας	v-sapamn-	ὄλλυμι	ᾱ
ὀλέσσας	v-sapamn-	ὄλλυμι	ᾱ
ὄλλυσιν	v3spia---	ὄλλυμι	ῡ
ὀλλυμένας	v-sppefg-	ὀλόλμαι	ᾱ
ὀλομένας	a-s---fg-	ὀλομένας	ᾱ
ὀλομένας	v-pppafa-	ὀλομένας	ᾱ
ὀλομένας	v-sppefg-	ὀλομένας	ᾱ
ὀλοάς	a-p---fa-	ὀλοός	ᾱ
ὀλοὰς	a-p---fa-	ὀλοός	ᾱ
ὁμαυλίας	n-s---fg-	ὁμαυλία	ᾱ
ὁμηρεύσας	v-sapamn-	ὁμηρεύω	ᾱ
ὁμιλίας	n-s---fg-	ὁμιλία	ᾱ
ὁμιλίας	n-p---fa-	ὁμιλία	ᾱ
ὄμνυμι	v1spia---	ὄμνυμι	ῡ
ὀμόσας	v-sapamn-	ὄμνυμι	ᾱ
ὁμοίας	a-p---fa-	ὅμοιος	ᾱ
ὁμοίας	a-s---fg-	ὅμοιος	ᾱ
Ὁμόλας	n-p---fa-	Ὁμόλη	Ᾱ
ὀμφάς	n-p---fa-	ὀμφή	ᾱ
ὀμφὰς	n-p---fa-	ὀμφή	ᾱ
ὀνομάσας	v-sapamn-	ὀνομάζω	αᾱ
ὀξυβόαν	a-s---ma-	ὀξυβόας	ᾱ
ὀξυθυμίας	n-s---fg-	ὀξυθυμία	ᾱ
ὁπλίσας	v-sapamn-	ὁπλίζω	ᾱ
ὁποίας	a-s---fg-	ὁποῖος	ᾱ
ὁπόσας	a-p---fa-	ὁπόσας	ᾱ
ὀπτάς	a-p---fa-	ὀπτή	ᾱ
ὀπώρας	n-s---fg-	ὀπώρα	ᾱ
ὅρα	v2spma---	ὅρα	ᾱ
Ὅρα	v2spma---	Ὅρα	Ᾱ
ὁρωμένας	v-pppefa-	ὁράομαι	ᾱ
ὅρα	v2spma---	ὁράω	ᾱ
Ὅρα	v2spma---	ὁράω	Ᾱ
ὥρα	v3siia---	ὁράω	ᾱ
Ὥρα	v3siia---	ὁράω	Ᾱ
ὀργάδας	n-p---fa-	ὀργάς	αᾱ
ὀργάς	n-p---fa-	ὀργάς	ᾱ
ὀργάς	n-p---fa-	ὀργή	ᾱ
ὀργάς	n-p---fa-	ὀργή	ᾱ
ὀργὰς	n-p---fa-	ὀργή	ᾱ
ὀρέξας	v-sapamn-	ὀρέγω	ᾱ
ὀρεσσιβάτα	n-s---mg-	ὀρεσσιβάτης	αᾱ
Ὀρέστα	n-s---mv-	Ὀρέστας	Ᾱ
Ὀρέσταν	n-s---ma-	Ὀρέστας	Ᾱ
Ὀρεστείας	a-s---fg-	Ὀρεστείας	Ᾱ
Ὀρέστα	n-s---mv-	ὀρέστης	Ᾱ
ὀρθομαντείας	n-s---fg-	ὀρθομαντείη	αᾱ
ὀρθάς	a-p---fa-	ὀρθός	ᾱ
ὀρθὰς	a-p---fa-	ὀρθός	ᾱ
ὁρκανάς	n-p---fa-	ὁρκαναί	αᾱ
ὁρκανὰς	n-p---fa-	ὁρκαναί	αᾱ
ὁρκωμοτήσας	v-sapamn-	ὁρκωμοτέω	ᾱ
ὁρμάσας	v-sapamn-	ὁρμάζω	αᾱ
ὁρμωμένας	v-pppefa-	ὁρμάομαι	ᾱ
ὁρμήσας	v-sapamn-	ὁρμέω	ᾱ
ὀρνυμένας	v-pppefa-	ὀρόνμαι	ᾱ
ὀρούσας	v-sapamn-	ὀρούω	ᾱ
ὁρώσας	v-sapamn-	ὁρόω	ᾱ
ὀρείας	a-s---fg-	ὀρύς	ᾱ
ὀρύξας	v-sapamn-	ὀρύσσω	ᾱ
ὀρφανάς	a-p---fa-	ὀρφανός	αᾱ
ὀρφανὰς	a-p---fa-	ὀρφανός	αᾱ
ὀρφναίας	a-p---fa-	ὀρφναίας	ᾱ
ὀρφναίας	a-s---fg-	ὀρφναῖος	ᾱ
ὁρώσας	v-pppafa-	ὁρώσας	ᾱ
ὁσίας	n-p---fa-	ὁσία	ᾱ
ὁσίας	a-p---fa-	ὁσῖος	ᾱ
ὁσίας	a-s---fg-	ὁσῖος	ᾱ
ὅσας	a-p---fa-	ὅσος	ᾱ
Ὄσσας	n-p---fa-	Ὄσση	Ᾱ
ὅσσας	a-p---fa-	ὅσση	ᾱ
οὐδαμᾷ	a-p---nn-	οὐδαμᾷ	αᾱ
οὐδαμᾷ	a-p---na-	οὐδαμᾷ	αᾱ
οὐρανίας	a-s---fg-	οὐρανῖος	αᾱ
οὐρείας	a-p---fa-	οὐρεῖος	ᾱ
οὐρεσιβώτας	n-s---mn-	οὐρεσιβώτας	ᾱ
οὐρίσας	v-sapamn-	οὐρίζω	ᾱ
οὐριθρέπταν	a-s---ma-	οὐριθρέπτης	ᾱ
οὐρίας	a-s---fg-	οὐρῖος	ᾱ
οὐσίας	n-s---fg-	οὐσία	ᾱ
οὐτάσας	v-sapamn-	οὐτάω	αᾱ
ταύτας	a-p---fa-	οὗτος	ᾱ
Ταύτας	a-p---fa-	οὗτος	Ᾱ
ὄχθας	n-p---fa-	ὄχθας	ᾱ
ὄχθας	n-p---fa-	ὄχθη	ᾱ
χυμένας	v-pppefa-	όχμαι	ᾱ
παγκοίτας	n-s---fg-	παγ	αᾱ
παγάς	n-p---fa-	παγὰι	αᾱ
παγὰς	n-p---fa-	παγὰι	αᾱ
παγάς	n-p---fa-	παγάς	αᾱ
παγάς	n-p---fa-	παγή	αᾱ
παγκληρίας	n-s---fg-	παγκληρία	αᾱ
παγκληρίας	a-s---fg-	παγκληρῖος	αᾱ
πάθας	n-p---fa-	πάθας	αᾱ
παιάν	n-s---ma-	παιάν	ᾱ
παιὰν	n-s---ma-	παιάν	ᾱ
παιδείας	n-s---fg-	παιδεία	ᾱ
παιδοκτονήσας	v-sapamn-	παιδοκτονέω	ᾱ
παίσας	v-sapamn-	παίσας	ᾱ
παίσας	v-sapamn-	παίω	ᾱ
παιωνίᾳ	a-p---na-	παιωνίᾳ	ᾱ
παιωνίας	a-p---fa-	παιωνῖος	ᾱ
παλαιᾶι	a-p---fn-	παλαιᾶι	αᾱ
παλαιᾶν	a-s---fa-	παλαιᾶν	αᾱ
παλαιᾷ	a-s---fd-	παλαιός	αᾱ
παλαιάς	a-p---fa-	παλαιός	αᾱ
παλαιάς	a-s---fg-	παλαιός	αᾱ
παλαιὰς	a-p---fa-	παλαιός	αᾱ
παλαιὰς	a-s---fg-	παλαιός	αᾱ
παλαιᾶς	a-s---fg-	παλαιός	αᾱ
παλαιᾶς	a-p---fa-	παλαιός	αᾱ
παλαίστρας	n-p---fa-	παλαίστρα	αᾱ
παλάμᾳ	n-p---na-	παλάμη	ααᾱ
πάλας	n-p---fa-	πάλη	αᾱ
Παλλάς	n-s---fg-	παλλάς	Αᾱ
Παλλὰς	n-s---fg-	παλλάς	Αᾱ
παλύνας	v-sapamn-	παλύνω	αᾱ
πανδημίᾳ	a-s---fn-	πανδημίᾳ	αᾱ
πανεργέτα	a-s---mv-	πανεργέτα	αᾱ
Πανθοΐδαν	n-s---ma-	Πανθοίδας	Αᾱ
πανουργίᾳ	n-s---fd-	πανουργία	αᾱ
πανουργίας	n-s---fg-	πανουργία	αᾱ
πανσαγίᾳ	n-p---na-	πανσαγίᾳ	ααᾱ
παντᾶ	a-s---ma-	παντᾶ	αᾱ
πάντᾳ	a-p---na-	πάντᾳ	αᾱ
παντευχίᾳ	a-p---na-	παντευχίᾳ	αᾱ
παντᾷ	a-p---nn-	πάντῃ	αᾱ
παντοδαπᾶς	a-p---fa-	παντοδαπᾶς	ααᾱ
παντοίᾳ	a-s---fd-	παντοῖος	αᾱ
παντοίας	a-p---fa-	παντοῖος	αᾱ
παντοίας	a-s---fg-	παντοῖος	αᾱ
παντόπτας	n-s---mn-	παντόπτης	αᾱ
παπτήνας	v-sapamn-	παπταίνω	αᾱ
παραβᾶσιν	n-s---fa-	παραβᾶσι	ααᾱ
παραγγείλας	v-sapamn-	παραγγέλλω	ααᾱ
παραδοχάς	n-p---fa-	παραδοχάς	ααᾱ
παραιτουμένᾳ	v-dppefn-	παραιτουμένᾳ	αᾱ
παραλίας	n-s---fg-	παραλῖα	ααᾱ
παραλλαγάς	n-p---fa-	παραλλαγή	αααᾱ
παραμυκᾶται	v3spie---	παραμυκάομαι	ααᾱ
παρανικᾷ	v3spia---	παρανικᾷ	ααᾱ
παρασπᾷ	v3spia---	παρασπάω	ααᾱ
παρασπᾷς	v2spia---	παρασπάω	ααᾱ
παραστάδας	n-p---fa-	παραστάς	αααᾱ
παραστᾶσ’	v-sapafn-	παραστᾶσ’	ααᾱ
παρβάδαν	n-s---ma-	παρβάδης	ααᾱ
παρειᾷ	n-s---fd-	παρειά	αᾱ
παρελθούσας	v-sapafg-	παρελθούσας	αᾱ
παρεστώσας	v-sapafg-	παρεστώσας	αᾱ
παρηίδας	n-p---fa-	παρηίδας	αᾱ
παρηίδας	n-p---fa-	παρηίς	αᾱ
παρθενείας	n-p---fa-	παρθενεία	αᾱ
παρθενίας	n-s---fg-	παρθενία	αᾱ
παραστάς	v-sapamn-	παρίστημι	ααᾱ
παραστάς	v-sapamn-	παρίστημι	ααᾱ
παραστὰς	v-sapamn-	παρίστημι	ααᾱ
Παρνασίας	n-s---fg-	Παρνασία	Ααᾱ
Παρνασίας	n-s---mn-	Παρνασίη	Ααᾱ
παροίξας	v-sapamn-	παροίξας	αᾱ
παρούσας	v-pppafa-	παρούσας	αᾱ
παρώσας	v-sapamn-	παρωθέω	αᾱ
πασᾶν	a-p---fg-	πᾶς	αᾱ
πασᾶν	a-s---fa-	πᾶς	αᾱ
πάσας	a-s---fg-	πᾶς	αᾱ
πάσας	a-p---fa-	πᾶς	αᾱ
πάσᾳ	a-s---fn-	πάσᾳ	αᾱ
πασαμένα	v-dapmfn-	πασαμένα	ααᾱ
πασᾶνγυναικων	a-p---fg-	πασᾶνγυναικῶν	αᾱ
πάσας	a-p---fa-	πάσας	αᾱ
πατάξας	v-sapamn-	πατάσσω	ααᾱ
πάτας	n-p---fa-	πάτη	αᾱ
πατουμένας	v-sppefg-	πατόομαι	αᾱ
πάτρας	n-s---fg-	πάτρα	αᾱ
πάτρᾳ	n-s---fn-	πάτρᾳ	αᾱ
πατρίας	a-s---fg-	πατρίη	αᾱ
πατρίας	a-p---fa-	πατρίη	αᾱ
πατρίας	a-s---fg-	πατρῖος	αᾱ
πατριώταν	n-s---ma-	πατριώτης	αᾱ
πατρῴᾳ	a-s---fd-	πατρῴᾳ	αᾱ
πατρῴας	a-s---fg-	πατρῷος	αᾱ
πάχνᾳ	a-p---na-	πάχνᾳ	αᾱ
παχῦναι	v--ana---	παχύνω	ῡ
πέδας	n-p---fa-	πέδας	ᾱ
πεδήσας	v-sapamn-	πεδάω	ᾱ
πέδας	n-p---fa-	πέδη	ᾱ
πείσας	v-sapamn-	πείθω	ᾱ
Πειρήνας	n-p---fa-	Πειρήνη	Ᾱ
πείσας	v-sapamn-	πείσας	ᾱ
πελαγίας	a-s---fg-	πελαγῖος	αᾱ
Πελασγίας	n-s---fg-	Πελασγία	Αᾱ
πελάταν	n-s---ma-	πελάτης	αᾱ
πελάσας	v-sapamn-	πελάω	αᾱ
πελειάς	n-s---fg-	πελειά	ᾱ
πελειάς	n-s---fg-	πελειά	ᾱ
πελειὰς	n-s---fg-	πελειά	ᾱ
πελείας	n-p---fa-	πελείας	ᾱ
πελείας	n-p---fa-	πελείη	ᾱ
πελείας	n-s---fg-	πελείη	ᾱ
Πελιάδας	n-p---fa-	Πελιάδας	Αᾱ
Πελιάδας	n-p---fa-	Πελιάδες	Αᾱ
Πελοπίας	n-s---fg-	Πελοπῖα	Ᾱ
Πελοπίας	n-s---fg-	Πελοπῖος	Ᾱ
πέλτας	n-p---fa-	πέλτη	ᾱ
πέμψας	v-sapamn-	πέμπω	ᾱ
πέρα	v2spma---	πέρα	ᾱ
περάνας	v-sapamn-	περαίνω	αᾱ
πέρας	n-s---na-	πέρας	ᾱ
περάσας	v-sapamn-	περάσας	αᾱ
περάσας	v-sapamn-	περάω	αᾱ
πέρσας	v-sapamn-	πέρθω	ᾱ
περιβολάς	n-p---fa-	περιβολή	ᾱ
περιβολὰς	n-p---fa-	περιβολή	ᾱ
περιδρομάς	n-p---fa-	περιδρομή	ᾱ
περιδρομὰς	n-p---fa-	περιδρομή	ᾱ
περιπλοκάς	n-p---fa-	περιπλοκά	ᾱ
περιπλοκὰς	n-p---fa-	περιπλοκά	ᾱ
περιποτᾶται	v3spie---	περιποτάομαι	ᾱ
περιπτύξας	v-sapamn-	περιπτύσσω	ᾱ
περιρρύτας	a-p---fa-	περιρρύτας	ᾱ
περιστᾶσαι	v-papafn-	περιστάζω	ᾱ
περιστείλας	v-sapamn-	περιστέλλω	ᾱ
Πέρσαν	n-s---ma-	Πέρσας	Ᾱ
Περσεφονείας	n-s---fg-	Περσεφονεία	Ᾱ
Περσεφόνας	n-p---fa-	Περσεφόνη	Ᾱ
πέρσαν	n-s---ma-	πέρσης	ᾱ
πεσούσας	v-papafa-	πεσίσκομαι	ᾱ
πέτρας	n-s---fg-	πέτρα	ᾱ
πέτρας	n-p---fa-	πέτρα	ᾱ
πετραίας	a-s---fg-	πετραῖος	ᾱ
πέτρας	n-p---fa-	πέτρας	ᾱ
πετρίνας	a-p---fa-	πετρίνας	ᾱ
πετομένας	v-pppefa-	πέτω	ᾱ
πεύκας	n-p---fa-	πεύκαι	ᾱ
πεύκας	n-p---fa-	πεύκας	ᾱ
πεφαργμένας	v-prpefa-	πεφαργμένας	αᾱ
πεφεύγασιν	v3pria---	πεφεύγασιν	ᾱ
πεφυρμένας	v-prpefa-	πεφυρμένας	ᾱ
πηγάς	n-p---fa-	Πηγαί	ᾱ
πηγάς	n-p---fa-	πηγή	ᾱ
πηγὰς	n-p---fa-	πηγή	ᾱ
πήγνυσιν	v3ppia---	πήγνυς	ῡ
πηδήσας	v-sapamn-	πηδάω	ᾱ
πηδήσας	v-sapamn-	πηδέω	ᾱ
Πηλεΐδας	n-s---mn-	Πηλεΐδαι	Ᾱ
πημήνας	v-sapamn-	πημήνας	ᾱ
πημονάς	n-p---fa-	πημονή	ᾱ
πημονὰς	n-p---fa-	πημονή	ᾱ
Πιερίδας	n-p---fa-	Πιερίς	Ᾱ
πικράς	a-s---fg-	πικράς	ᾱ
πικρὰς	a-s---fg-	πικρὰς	ᾱ
πικρᾷ	a-s---fd-	πικρός	ᾱ
πικράς	a-s---fg-	πικρός	ᾱ
πικράς	a-p---fa-	πικρός	ᾱ
πικρὰς	a-s---fg-	πικρός	ᾱ
πικρὰς	a-p---fa-	πικρός	ᾱ
πικρᾶς	a-s---fg-	πικρός	ᾱ
πικρᾶς	a-p---fa-	πικρός	ᾱ
πλήσας	v-sapamn-	πίμπλημι	ᾱ
πιμπρᾶσιν	v3ppia---	πιμπρᾶ	ᾱ
πιμπρᾶσι	v3spia---	πιμπρᾶμί	ᾱ
πιστεύσας	v-sapamn-	πιστεύω	ᾱ
πιστάς	a-p---fa-	πιστός	ᾱ
πιστὰς	a-p---fa-	πιστός	ᾱ
πιστοτάτας	a-p---fas	πιστός	αᾱ
Πιτάνας	n-s---fg-	Πιτάνη	Αᾱ
πιτνούσας	v-pppafa-	πιτνούσας	ᾱ
πιείρας	a-s---fg-	πίων	ᾱ
πλαγᾶι	n-p---fn-	πλαγᾶι	αᾱ
πλαγάς	n-p---fa-	πλαγή	αᾱ
πλαγὰς	n-p---fa-	πλαγή	αᾱ
πλάκας	n-p---fa-	πλάκας	αᾱ
πλάκας	n-p---fa-	πλάκη	αᾱ
πλανᾷ	v3spia---	πλανάω	αᾱ
πλανᾶσθαι	v--pne---	πλανάω	αᾱ
πλανᾶσθε	v2ppie---	πλανάω	αᾱ
πλάνας	n-p---fa-	πλάνη	αᾱ
πλατᾶν	n-s---fa-	πλατᾶν	αᾱ
πλατείας	n-s---fg-	πλατεῖα	αᾱ
πλάτας	n-p---fa-	πλάτη	αᾱ
Πλειάδας	n-s---fg-	Πλειάδας	Αᾱ
Πλειάς	n-p---fa-	Πλειάς	Ᾱ
Πλειὰς	n-p---fa-	Πλειὰς	Ᾱ
Πλεισθενιδᾶν	n-s---ma-	Πλεισθενίδης	Ᾱ
πλείστας	a-p---fa-	πλεῖστος	ᾱ
πλεκτάς	a-p---fa-	πλεκτός	ᾱ
πλεκτὰς	a-p---fa-	πλεκτός	ᾱ
πλευράς	n-p---fa-	πλευρά	ᾱ
πλευράς	n-p---fa-	πλευρά	ᾱ
πλευρὰς	n-p---fa-	πλευρά	ᾱ
πλεύσας	v-sapamn-	πλέω	ᾱ
πληγάς	n-p---fa-	πληγή	ᾱ
πληγάς	n-p---fa-	πληγή	ᾱ
πληγὰς	n-p---fa-	πληγή	ᾱ
πλημμελήσας	v-sapamn-	πλημμελέω	ᾱ
πλησίας	a-s---fg-	πλησίας	ᾱ
πλησμονάς	n-p---fa-	πλησμονά	ᾱ
πλησμονὰς	n-p---fa-	πλησμονά	ᾱ
πλοκάς	n-p---fa-	πλοκή	ᾱ
πλοκὰς	n-p---fa-	πλοκή	ᾱ
πνεύσας	v-sapamn-	πνέω	ᾱ
πνοάς	n-p---fa-	πνοάς	ᾱ
πνοάς	n-p---fa-	πνοή	ᾱ
πνοάς	n-p---fa-	πνοή	ᾱ
πνοὰς	n-p---fa-	πνοή	ᾱ
ποδωκείας	n-s---fg-	ποδωκεεία	ᾱ
ποίας	a-s---fg-	ποίας	ᾱ
ποιήσας	v-sapamn-	ποιέω	ᾱ
ποικίλας	v-sapamn-	ποικίλλω	ᾱ
ποίμνας	n-p---fa-	ποίμνη	ᾱ
ποινάς	n-p---fa-	ποινή	ᾱ
ποινάς	n-p---fa-	ποινή	ᾱ
ποινὰς	n-p---fa-	ποινή	ᾱ
ποίας	a-s---fg-	ποῖος	ᾱ
ποίας	a-p---fa-	ποῖος	ᾱ
Ποίας	a-s---fg-	ποῖος	Ᾱ
Ποίας	a-p---fa-	ποῖος	Ᾱ
πολεμίας	a-s---fg-	πολεμῖος	ᾱ
πολεμίας	a-p---fa-	πολεμῖος	ᾱ
πολεμίᾳ	a-s---fd-	πολέμιος	ᾱ
πολιαινομένας	v-pppefa-	πολιαινομένας	ᾱ
πολιᾶν	a-s---fa-	πολιᾶν	ᾱ
Πολιάς	n-p---fa-	Πολιάς	Ᾱ
πολιᾶς	n-p---fa-	πολιᾶς	ᾱ
πολιάς	n-p---fa-	πολιός	ᾱ
πολιάς	a-p---fa-	πολιός	ᾱ
πολιὰς	n-p---fa-	πολιός	ᾱ
πολιὰς	a-p---fa-	πολιός	ᾱ
πολιτᾶν	n-s---fa-	πολιτᾶν	ᾱ
πολιτᾶν	n-s---ma-	πολιτᾶν	ᾱ
πολιτᾶν	a-s---fa-	πολιτάω	ᾱ
πλείστας	a-p---fas	πολύς	ᾱ
πολλά	a-d---fn-	πολύς	ᾱ
πολλὰ	a-d---fn-	πολύς	ᾱ
πολλάς	a-p---fa-	πολύς	ᾱ
πολλάς	a-p---fa-	πολύς	ᾱ
Πολλάς	a-p---fa-	πολύς	Ᾱ
πολλὰς	a-p---fa-	πολύς	ᾱ
Πολλὰς	a-p---fa-	πολύς	Ᾱ
πολύτλας	a-s---mn-	πολύτλας	ᾱ
πονήσας	v-sapamn-	πονέω	ᾱ
πονηράς	a-p---fa-	πονηρός	ᾱ
πονηρὰς	a-p---fa-	πονηρός	ᾱ
ποντίας	n-s---fg-	ποντία	ᾱ
ποντιᾶν	a-s---fa-	ποντιᾶν	ᾱ
ποντιάς	a-s---fg-	ποντιάς	ᾱ
ποντιὰς	a-s---fg-	ποντιὰς	ᾱ
ποντίας	a-s---fg-	ποντίη	ᾱ
ποντίας	n-s---fg-	ποντίη	ᾱ
ποντίας	a-s---fg-	ποντῖος	ᾱ
ποντίας	a-p---fa-	ποντῖος	ᾱ
πορείας	n-s---fg-	πορεία	ᾱ
πορεύσας	v-sapamn-	πορεύω	ᾱ
πορθουμένας	v-pppafa-	πορθόομαι	ᾱ
πόρπας	n-p---fa-	πόρπη	ᾱ
πορσύνας	v-sapamn-	πορσύνω	ᾱ
πορφυρᾷ	n-s---fd-	πορφυρᾷ	ᾱ
πορφύρας	n-s---fg-	πορφύρα	ᾱ
πορφυρέας	a-p---fa-	πορφύρεος	ᾱ
πόσας	a-p---fa-	πόσος	ᾱ
ποταμίας	a-p---fa-	ποταμῖος	αᾱ
ποταμίας	a-s---fg-	ποταμῖος	αᾱ
ποτνιάδας	n-p---fa-	ποτνιάς	αᾱ
πράξας	v-sapamn-	πράξας	αᾱ
πράξας	v-sapamn-	πράσσω	αᾱ
Πριαμίδαν	n-s---ma-	Πριαμίδαν	Αᾱ
πρόβα	v2spma---	πρόβα	ᾱ
προβάς	v-sapamn-	προβαίνω	ᾱ
προβάς	v-sapamn-	προβαίνω	ᾱ
προβὰς	v-sapamn-	προβαίνω	ᾱ
πρόβα	v2spma---	πρόβη	ᾱ
προδείσας	v-sapamn-	προδείδω	ᾱ
προδεικνύς	v-sppamn-	προδείκνυμι	ῡ
προδεικνὺς	v-sppamn-	προδείκνυμι	ῡ
προδόταν	n-s---ma-	προδότης	ᾱ
προθυμίας	n-p---fa-	προθυμία	ᾱ
προθυμίας	n-s---fg-	προθυμία	ᾱ
Προιτίδας	a-p---fa-	Προιτίδας	Ᾱ
προκλίνας	v-sapamn-	προκλίνω	ᾱ
προκρίνας	v-sapamn-	προκρίνω	ᾱ
προμεμοχθήκασι	v3pria---	προμεμοχθίσκω	ᾱ
προμηθίᾳ	n-s---fn-	προμήθειᾳ	ᾱ
προμηθίᾳ	n-s---fd-	προμηθία	ᾱ
προμηθίας	n-s---fg-	προμηθία	ᾱ
προνοίας	n-s---fg-	πρόνοια	ᾱ
πρόπας	a-s---mn-	πρόπας	ᾱ
προπονουμένας	v-sppefg-	προπονέω	ᾱ
προσάψας	v-sapamn-	προσάπτω	αᾱ
προσαρμόσας	v-sapamn-	προσαρμόζω	αᾱ
προσβάς	v-sapamn-	προσβαίνω	ᾱ
προσβὰς	v-sapamn-	προσβαίνω	ᾱ
προσβλέψας	v-sapamn-	προσβλέπω	ᾱ
προσβολάς	n-p---fa-	προσβολή	ᾱ
προσβολάς	n-p---fa-	προσβολή	ᾱ
προσβολὰς	n-p---fa-	προσβολή	ᾱ
προσδόκα	v2spma---	προσδοκάω	ᾱ
προσέβα	v3siia---	προσέβα	ᾱ
προσέπτα	v3siia---	προσέπτα	ᾱ
προσερπούσας	v-pppafa-	προσερπούσας	ᾱ
προσηγορήσας	v-sapamn-	προσηγορέω	ᾱ
προσενώμα	v3siia---	προσινωμάω	ᾱ
προσκύσας	v-sapamn-	προσκύω	ᾱ
προσπέμψας	v-sapamn-	προσπέμπω	ᾱ
προσπολουμένας	v-pppefa-	προσπολόομαι	ᾱ
προστάξας	v-sapamn-	προστάσσω	αᾱ
προστάταν	n-s---ma-	προστάταν	αᾱ
προστατηρίας	n-s---fg-	προστατηρία	αᾱ
προστάταν	n-s---ma-	προστάτης	αᾱ
προτάξας	v-sapamn-	προτάσσω	αᾱ
προτείνας	v-sapamn-	προτείνον	ᾱ
προτέρας	a-p---fa-	πρότερος	ᾱ
πρώτας	a-p---fas	πρότερος	ᾱ
προτίσας	v-sapamn-	προτίζω	ᾱ
προτιμᾶι	v3spia---	προτιμᾶι	ᾱ
προτιμᾷ	v3spia---	προτιμάω	ᾱ
προυμόσας	n-p---fa-	προυμόση	ᾱ
προχοάς	n-p---fa-	προχοή	ᾱ
προχοὰς	n-p---fa-	προχοή	ᾱ
πρυμνᾶν	n-s---fa-	πρυμνᾶ	ᾱ
πρύμνας	n-s---fg-	πρύμνα	ᾱ
πρύμνας	n-p---fa-	πρύμνα	ᾱ
πρῴρας	n-p---fa-	πρῷρα	ᾱ
πρώτας	a-p---fa-	πρῶτος	ᾱ
πταίσας	v-sapamn-	πταίω	ᾱ
πτερωτάς	a-p---fa-	πτερωτός	ᾱ
πτερωτὰς	a-p---fa-	πτερωτός	ᾱ
πτήξας	v-sapamn-	πτήζω	ᾱ
πτύξας	v-sapamn-	πτύσσω	ᾱ
πτυχάς	n-p---fa-	πτυχάς	ᾱ
πτυχάς	n-p---fa-	πτυχάς	ᾱ
πτυχὰς	n-p---fa-	πτυχὰς	ᾱ
πτυχάς	n-p---fa-	πτυχή	ᾱ
πτυχὰς	n-p---fa-	πτυχή	ᾱ
πτύσας	v-sapamn-	πτύω	ᾱ
πτωχάς	a-p---fa-	πτωχός	ᾱ
πτωχὰς	a-p---fa-	πτωχός	ᾱ
πυκνάς	a-p---fa-	πυκνός	ᾱ
πυκνὰς	a-p---fa-	πυκνός	ᾱ
πυλᾶν	n-s---fa-	πυλᾶ	ᾱ
Πυλάδας	n-s---fg-	Πυλάδη	Αᾱ
πύλας	n-p---fa-	πύλας	ᾱ
πύλας	n-p---fa-	πύλη	ᾱ
Πύλας	n-p---fa-	πύλη	Ᾱ
πυρᾶι	n-p---fn-	πυρᾶ	ᾱ
πυρᾶι	n-p---fd-	πυρᾶ	ᾱ
πυρᾶι	n-s---fd-	πυρᾶι	ᾱ
πυρᾶι	u--------	πυρᾶι	ᾱ
πυργώσας	v-sapamn-	πυργώω	ᾱ
πυρᾷ	n-s---fd-	πυρή	ᾱ
πυρᾶς	n-p---fa-	πυρή	ᾱ
πυρᾶς	n-s---fg-	πυρή	ᾱ
πυριγενετᾶν	a-p---na-	πυριγενετᾶς	ᾱ
πυρκαιάς	n-p---fa-	πυρκαιή	ᾱ
πυρκαιὰς	n-p---fa-	πυρκαιή	ᾱ
πυρώσας	v-sapamn-	πυρόω	ᾱ
πυρρίχας	n-p---fa-	πυρρίχη	ᾱ
πυρσεύσας	v-sapamn-	πυρσεύω	ᾱ
πωλοδαμνήσας	v-sapamn-	πωλοδαμνάω	αᾱ
ῥᾴδιον	a-s---nn-	ῥᾴδιος	ᾱ
ῥᾳδίως	d--------	ῥᾴδιος	ᾱ
ῥᾴθυμος	a-s---fn-	ῥᾴθυμος	ᾱ
ῥαφάς	n-p---fa-	ῥαφή	αᾱ
ῥέξας	v-sapamn-	ῥέδω	ᾱ
Ῥέας	v-sapamn-	Ῥέη	Ᾱ
Ῥέας	n-s---fg-	Ῥέη	Ᾱ
ῥήξας	v-sapamn-	ῥήγνυμι	ᾱ
ῥήγνυσιν	v3ppia---	ῥήγνυσιν	ῡ
ῥίζας	n-p---fa-	ῥίζα	ᾱ
ῥίζας	n-s---fg-	ῥίζα	ᾱ
ῥιπᾶι	n-p---fn-	ῥιπᾶι	ᾱ
Ῥιπᾶν	n-s---fa-	Ῥιπᾶν	Ᾱ
ῥιπάς	n-p---fa-	ῥιπή	ᾱ
ῥίψας	v-sapamn-	ῥίπτω	ᾱ
ῥοάς	n-p---fa-	ῥοή	ᾱ
ῥοάς	n-p---fa-	ῥοή	ᾱ
ῥοὰς	n-p---fa-	ῥοή	ᾱ
ῥυσά	v2spma---	ῥυ	ᾱ
ῥυσὰ	v2spma---	ῥυ	ᾱ
ῥυτᾶς	n-p---fa-	ῥυτᾶς	ᾱ
Σαλαμῖν’	a-s---fa-	Σαλαμῖν	Ῑ
σαλαμῖνα	n-s---fa-	Σαλαμῖνά	ῑ
Σαλαμῖνα	n-s---fa-	σαλαμίς	Ῑ
Σαλαμῖνος	n-s---fg-	σαλαμίς	Ῑ
σάρκας	n-p---fa-	σάρξ	αᾱ
σάς	a-p---fa-	σάς	ᾱ
σαφηνείᾳ	n-s---fd-	σαφηνείᾳ	αᾱ
σαφηνίσας	v-sapamn-	σαφηνίζω	αᾱ
σέβας	n-s---na-	σέβας	ᾱ
σέβας	n-s---nn-	σέβας	ᾱ
σέβας	n-s---nv-	σέβας	ᾱ
σελάνας	n-p---fa-	σελάνη	αᾱ
σέλας	n-s---nv-	σέλας	ᾱ
σέλας	n-s---na-	σέλας	ᾱ
σέλας	n-s---nn-	σέλας	ᾱ
σελήνας	n-p---fa-	σελήνη	ᾱ
Σεμέλας	n-s---fg-	Σεμέλα	Ᾱ
Σεμέλας	n-s---mn-	Σεμέλας	Ᾱ
Σεμέλας	n-s---fg-	Σεμέλη	Ᾱ
Σεμέλας	n-p---fa-	Σεμέλη	Ᾱ
σεμνάς	a-p---fa-	σεμνός	ᾱ
σεμνάς	a-p---fa-	σεμνός	ᾱ
σεμνὰς	a-p---fa-	σεμνός	ᾱ
σημήνας	v-sapamn-	σημαίνω	ᾱ
σιγᾶθ’	v2ppma---	σιγᾶθ	ᾱ
σιγᾶι	v3spia---	σιγᾶι	ᾱ
σιγᾶι	v2spie---	σιγᾶι	ᾱ
σιγᾶι	v--ana---	σιγᾶι	ᾱ
σιγᾶις	v2spoa---	σιγᾶις	ᾱ
σιγᾶν	v--pna---	σιγᾶν	ᾱ
σιγᾶς	n-p---fa-	σιγᾶς	ᾱ
σιγᾷς	v2spia---	σιγᾷς	ᾱ
Σιγᾶτ’	v2ppma---	Σιγᾶτ	Ᾱ
σιγᾶτ’	v2ppma---	σιγᾶτ’	ᾱ
σίγα	v2spma---	σιγάω	ᾱ
Σίγα	v2spma---	σιγάω	Ᾱ
σιγᾶν	v--pna---	σιγάω	ᾱ
Σιγᾶν	v--pna---	σιγάω	Ᾱ
σιγᾶτε	v2ppma---	σιγάω	ᾱ
Σιγᾶτε	v2ppma---	Σιγάω	Ᾱ
σιδηρᾶ	a-p---na-	σιδηρᾶ	ᾱ
Σιδονίᾳ	a-p---na-	σιδόνιος	Ᾱ
Σιδωνιάς	a-p---fa-	Σιδωνιὰ	Ᾱ
Σιδωνιὰς	a-p---fa-	Σιδωνιὰ	Ᾱ
Σικελίας	n-s---fg-	σικελία	Ᾱ
Σιμοεντιάδας	n-p---fa-	Σιμοεντιάς	Αᾱ
Σιμουντίδας	a-p---fa-	Σιμουντίς	Ᾱ
Σισυφιδᾶν	n-p---mg-	Σισυφίδης	Ᾱ
σιωπᾶσθαι	v--pne---	σιωπάομαι	ᾱ
σιώπα	v2spma---	σιωπάω	ᾱ
σιωπᾶν	v--pna---	σιωπάω	ᾱ
σιωπᾷς	v2spia---	σιωπάω	ᾱ
σιωπήσας	v-sapamn-	σιωπάω	ᾱ
σκηνάς	n-p---fa-	σκηνή	ᾱ
σκηνάς	n-p---fa-	σκηνή	ᾱ
σκηνὰς	n-p---fa-	σκηνή	ᾱ
σκηπτουχίᾳ	a-p---na-	σκηπτουχία	ᾱ
σκήψας	v-sapamn-	σκήπτω	ᾱ
σκιᾷ	n-s---fn-	σκιά	ᾱ
σκιᾷ	n-s---fd-	σκιά	ᾱ
σκιᾶς	n-s---fg-	σκιά	ᾱ
σκιερᾶι	a-p---fn-	σκιερᾶι	ᾱ
σκιρτᾷ	a-p---nn-	σκιρτᾷ	ᾱ
σκοπιάς	n-p---fa-	σκοπιὰ	ᾱ
σκοπιὰς	n-p---fa-	σκοπιὰ	ᾱ
σκοπιάς	n-p---fa-	σκοπιή	ᾱ
σκοτεινάς	a-p---fa-	σκοτεινός	ᾱ
σκοτεινὰς	a-p---fa-	σκοτεινός	ᾱ
σκοτίας	n-s---fg-	σκοτία	ᾱ
σμικρᾷ	a-p---na-	σμικρᾷ	ᾱ
σμικρᾶι	a-p---fn-	σμικρᾶι	ᾱ
σμύρνας	n-s---fg-	σμύρνα	ᾱ
σάς	a-p---fa-	σός	ᾱ
σάς	a-p---fa-	σός	ᾱ
σάς	a-s---fg-	σός	ᾱ
σὰς	a-p---fa-	σός	ᾱ
σὰς	a-s---fg-	σός	ᾱ
Σούσας	n-s---mn-	Σούση	Ᾱ
σοφίᾳ	n-s---fd-	σοφία	ᾱ
Σοφίᾳ	n-s---fd-	σοφία	Ᾱ
σοφίας	n-s---fg-	σοφία	ᾱ
σοφάς	a-p---fa-	σοφός	ᾱ
σοφὰς	a-p---fa-	σοφός	ᾱ
σπάσας	v-sapamn-	σπάζω	αᾱ
σπαρνάς	n-p---fa-	σπαρνή	αᾱ
σπαρνὰς	n-p---fa-	σπαρνή	αᾱ
Σπαρτιᾶτιν	n-s---fa-	Σπαρτιᾶτις	Αᾱ
Σπαρτιᾶτις	n-s---fn-	Σπαρτιᾶτις	Αᾱ
σπάσας	v-sapamn-	σπάσας	αᾱ
σπείρας	v-sapamn-	σπείρω	ᾱ
σπείρας	n-s---fg-	σπείρω	ᾱ
σπείρας	n-p---fa-	σπείρω	ᾱ
σπονδάς	n-p---fa-	σπονδή	ᾱ
σπονδάς	n-p---fa-	σπονδή	ᾱ
σπονδὰς	n-p---fa-	σπονδή	ᾱ
σπουδάσας	v-sapamn-	σπουδάδω	αᾱ
σταγόνας	n-p---fa-	σταγόνας	αᾱ
σταγόνας	n-p---fa-	σταγόνη	αᾱ
σταθμᾶσθαι	v--pne---	σταθμάω	αᾱ
σταθμήσας	v-sapamn-	σταθμήζω	αᾱ
στάς	v-sapamn-	σταίνω	ᾱ
στέγας	n-p---fa-	στέγας	ᾱ
στέγας	n-s---fg-	στέγη	ᾱ
στέγας	n-p---fa-	στέγη	ᾱ
στείλας	v-sapamn-	στείλω	ᾱ
στέρξας	v-sapamn-	στέργω	ᾱ
στερεάς	a-p---fa-	στερεάς	ᾱ
στερήσας	v-sapamn-	στερήσας	ᾱ
στερράς	n-p---fa-	στερρά	ᾱ
στερρὰς	n-p---fa-	στερρά	ᾱ
στεφάναν	n-s---ma-	στεφάνας	αᾱ
στεφάνας	n-s---fg-	στεφάνη	αᾱ
στιβάδας	n-p---fa-	στιβάδας	αᾱ
στίχας	n-p---fa-	στίξ	ᾱ
στίχας	n-p---fa-	στίχας	ᾱ
στολάς	n-p---fa-	στολή	ᾱ
στολάς	n-p---fa-	στολή	ᾱ
στολὰς	n-p---fa-	στολή	ᾱ
στοναχάς	n-p---fa-	στοναχή	αᾱ
στοναχὰς	n-p---fa-	στοναχή	αᾱ
στορέσας	v-sapamn-	στορέννυμι	ᾱ
στρατείας	n-s---fg-	στρατεία	αᾱ
στρατηγίας	n-s---fg-	στρατηγία	αᾱ
στρατηλατᾶν	n-s---ma-	στρατηλατάω	ααᾱ
στρατηλατήσας	v-sapamn-	στρατηλατέω	ααᾱ
στρατηλάτα	n-s---mg-	στρατηλάτης	ααᾱ
στρατηλάταν	n-s---ma-	στρατηλάτης	ααᾱ
στρατηλάτας	n-s---mn-	στρατηλάτης	ααᾱ
στρατιάς	n-p---fa-	στρατιά	αᾱ
στρατιὰς	n-p---fa-	στρατιά	αᾱ
στρατιᾶς	n-s---fg-	στρατιά	αᾱ
στρέψας	v-sapamn-	στρέφω	ᾱ
στροφάς	n-p---fa-	στροφή	ᾱ
στροφὰς	n-p---fa-	στροφή	ᾱ
στροφίδας	n-p---fa-	στροφίς	ᾱ
στυγερᾶι	a-p---fn-	στυγερᾶι	ᾱ
στυγερᾶι	a-p---fd-	στυγερᾶι	ᾱ
στυγερᾶς	a-p---fa-	στυγερός	ᾱ
στυγερᾶς	a-s---fg-	στυγερός	ᾱ
στυγήσας	v-sapamn-	στυγήσας	ᾱ
στυγνάς	a-p---fa-	στυγνός	ᾱ
στυγνὰς	a-p---fa-	στυγνός	ᾱ
ὑμᾶς	p-p---ma-	σύ	ᾱ
ὑμᾶς	p-p----a-	σύ	ᾱ
ὑμᾶς	p-p---fa-	σύ	ᾱ
ὑμῖν	p-p---fd-	σύ	ῑ
ὑμῖν	p-p----d-	σύ	ῑ
ὑμῖν	p-p---md-	σύ	ῑ
ὑμῖν	p2p----d-	σύ	ῑ
Ὑμῖν	p-p----d-	σύ	Ῑ
Ὑμῖν	p-p---md-	σύ	Ῑ
συγκαθημένας	v-prpefa-	συγκαθημένας	αᾱ
συγκατακτάς	v-sapamn-	συγκατακτείνω	ααᾱ
συγκατακτὰς	v-sapamn-	συγκατακτείνω	ααᾱ
συγκῦρσαι	v--ana---	συγκῦρζω	υῡ
συγχέας	v-sapamn-	συγχέλω	ᾱ
συγχέας	v-sapamn-	συγχέω	ᾱ
συγχωρούσας	v-pppafa-	συγχωράω	ᾱ
συλᾶι	v3saoa---	συλᾶι	ᾱ
συλᾶις	n-p---fd-	συλᾶις	ᾱ
συλᾶσθ’	v1ppip---	συλᾶσθ	ᾱ
συλᾶται	v3spie---	συλᾶται	ᾱ
συλᾶν	v--pna---	συλάω	ᾱ
συλᾶσθαι	v--anm---	συλάω	ᾱ
συλᾶσθαι	v--pne---	συλάω	ᾱ
συλλαβάς	n-p---fa-	συλλαβή	αᾱ
συλλαβὰς	n-p---fa-	συλλαβή	αᾱ
συμφορᾶι	n-p---fn-	συμ	ᾱ
συμβάς	v-sapamn-	συμβαίνω	ᾱ
συμβὰς	v-sapamn-	συμβαίνω	ᾱ
ξυμμαχίας	a-s---fg-	συμμαχία	αᾱ
συμμείξας	v-sapamn-	συμμείσσω	ᾱ
σύμπας	a-s---mn-	σύμπας	ᾱ
συμπήξας	v-sapamn-	συμπήγω	ᾱ
Συμπληγάδας	n-p---fa-	Συμπλαγάς	Αᾱ
Συμπληγάδας	v-sapamn-	Συμπληγάδας	Αᾱ
Συμπληγάδας	n-p---fa-	Συμπληγάς	Αᾱ
συμπονήσας	v-sapamn-	συμπονέω	ᾱ
συμφορᾷ	n-s---fd-	συμφορά	ᾱ
συμφοράς	n-s---fg-	συμφορά	ᾱ
συμφοράς	n-p---fa-	συμφορά	ᾱ
συμφοράς	n-s---fg-	συμφορά	ᾱ
συμφοράς	n-p---fa-	συμφορά	ᾱ
συμφορὰς	n-p---fa-	συμφορά	ᾱ
συμφορὰς	n-s---fg-	συμφορά	ᾱ
συμφορᾶς	n-s---fg-	συμφορά	ᾱ
συμφορᾶς	n-p---fa-	συμφορά	ᾱ
συμφοράς	n-p---fa-	συμφορὰ	ᾱ
συμφορὰς	n-p---fa-	συμφορὰ	ᾱ
συμφορᾶι	n-p---fd-	συμφορᾶ	ᾱ
συμφορᾶι	n-p---fn-	συμφορᾶ	ᾱ
συμφορᾶι	u--------	συμφορᾶι	ᾱ
συμφορᾶι	n-p---fn-	συμφορᾶι	ᾱ
συμφορᾶι	n-s---fd-	συμφορᾶς	ᾱ
συμφορᾶς	n-s---fg-	συμφορᾶς	ᾱ
συμφυγάδας	n-p---fa-	συμφυγάς	αᾱ
συνᾶγε	v3siia---	συνᾶγω	ᾱ
ξυνᾴδει	v3spia---	συνᾴδω	ᾱ
συναλλαγάς	n-p---fa-	συναλλαγάς	ααᾱ
συναμιλλᾶται	v3spie---	συναμιλλᾶται	αᾱ
συνάψας	v-sapamn-	συνάπτω	αᾱ
συναρμόσας	v-sapamn-	συναρμόζω	αᾱ
συναρπάσας	v-sapamn-	συναρπάζω	ααᾱ
συνασχαλᾷ	v1sria---	συνασχαλάω	ααᾱ
συνδαίσας	v-sapamn-	συνδαίζω	ᾱ
συνδήσας	v-sapamn-	συνδάω	ᾱ
συνδήσας	v-sapamn-	συνδέω	ᾱ
συνδρᾶι	v3saia---	συνδρᾶι	ᾱ
συνδρομάδας	n-p---fa-	συνδρομάς	αᾱ
συνθήκας	n-p---fa-	συνθήκη	ᾱ
συνναύταν	n-s---ma-	συνναύτης	ᾱ
συννικᾶις	v2spia---	συννικᾶις	ᾱ
συννοίᾳ	n-s---fd-	συννοίᾳ	ᾱ
συννοίας	n-p---fa-	συννοίη	ᾱ
συνοικίσας	v-sapamn-	συνοικίζω	ᾱ
συντυχίας	n-p---fa-	συντυχία	ᾱ
Συρίᾳ	n-s---fd-	Συρία	Ᾱ
σφαγάς	n-p---fa-	σφαγάς	αᾱ
σφαγᾶς	n-p---fa-	σφαγᾶς	αᾱ
σφαγάς	n-p---fa-	σφαγή	αᾱ
σφαγάς	n-p---fa-	σφαγή	αᾱ
σφαγὰς	n-p---fa-	σφαγή	αᾱ
σφάξας	v-sapamn-	σφάζω	αᾱ
σφενδόνας	n-p---fa-	σφενδόνη	ᾱ
σφραγῖδα	n-s---fa-	σφραγίς	ῑ
σφραγῖδος	n-s---fg-	σφραγίς	ῑ
σχάσας	v-sapamn-	σχάσας	αᾱ
σχεδίᾳ	n-s---fd-	σχεδία	ᾱ
σχεδίας	n-p---fa-	σχεδίη	ᾱ
σχετλίᾳ	a-p---nn-	σχετλίᾳ	ᾱ
σώσας	v-sapamn-	σώζω	ᾱ
σώσας	v-sapamn-	σώσας	ᾱ
σωτηρίᾳ	n-s---fd-	σωτηρία	ᾱ
σωτηρίας	n-s---fg-	σωτηρία	ᾱ
σωφροσύνας	n-p---fa-	σωφροσύνα	ᾱ
τακομένας	v-pppafa-	τακομέ	αᾱ
ταλαίνᾳ	a-s---fn-	ταλαίνᾳ	αᾱ
ταλαινᾶν	a-s---fa-	ταλαινᾶν	αᾱ
ταλαίνας	a-s---fg-	ταλαίνας	αᾱ
ταλαίνας	a-p---fa-	ταλαίνας	αᾱ
ταλαίνας	a-p---fa-	ταλαῖνος	αᾱ
τάλας	a-s---mn-	τάλας	αᾱ
Τάλας	a-s---mn-	τάλας	Αᾱ
ταμίας	a-s---mn-	ταμίας	αᾱ
ταμίαν	a-s---ma-	ταμίης	αᾱ
τἀνδεᾶ	a-p---na-	τἀνδεᾶ	αᾱ
πταμένας	v-prpefa-	τάννυμι	αᾱ
Τανταλιδᾶν	a-s---fa-	Τανταλιδᾶ	Ααᾱ
τανῦν	d--------	τανῦν	ῡ
Τανῦν	d--------	τανῦν	Ῡ
τανύσας	v-sapamn-	τανύω	αᾱ
ταράξας	v-sapamn-	ταράξας	ααᾱ
ταράς	v-sapamn-	ταράς	αᾱ
ταράξας	v-sapamn-	ταράσσω	ααᾱ
ταρβήσας	v-sapamn-	ταρβέω	αᾱ
τάξας	v-sapamn-	τάσσω	αᾱ
τᾶςτυράννου	n-s---fg-	τᾶςτυράννου	ᾱα
ταφάς	n-p---fa-	ταφή	αᾱ
ταφὰς	n-p---fa-	ταφή	αᾱ
ταχύνας	v-sapamn-	ταχύνω	αᾱ
ταχείας	a-s---fg-	ταχύς	αᾱ
τέγξας	v-sapamn-	τέγσσω	ᾱ
τείσας	v-sapamn-	τείζω	ᾱ
τείνας	v-sapamn-	τείνω	ᾱ
Τειρεσία	n-s---mv-	Τειρεσία	Ᾱ
Τειρεσία	n-s---mv-	Τειρεσίας	Ᾱ
Τειρεσίας	n-s---mn-	Τειρεσίας	Ᾱ
Τειρεσία	n-s---mv-	τειρεσίης	Ᾱ
Τειρεσίαν	n-s---ma-	τειρεσίης	Ᾱ
τελείας	a-s---fg-	τελεῖος	ᾱ
τελετάς	n-p---fa-	τελετή	ᾱ
τελετάς	n-p---fa-	τελετή	ᾱ
τελετὰς	n-p---fa-	τελετή	ᾱ
τελευτήσας	v-sapamn-	τελευτάω	ᾱ
τελευτάς	n-p---fa-	τελευτή	ᾱ
τελευτάς	n-p---fa-	τελευτή	ᾱ
τελευτὰς	n-p---fa-	τελευτή	ᾱ
τελευτώσας	v-sapamn-	τελευτόω	ᾱ
τελέσας	v-sapamn-	τελέω	ᾱ
τελουμένας	v-pppefa-	τελουμένας	ᾱ
τέρας	n-s---nn-	τέρας	ᾱ
τέρας	n-s---na-	τέρας	ᾱ
τερπνάς	a-p---fa-	τερπνός	ᾱ
τερπνὰς	a-p---fa-	τερπνός	ᾱ
τεύξας	v-sapamn-	τεύκω	ᾱ
τέχνας	n-s---fg-	τέχνη	ᾱ
τέχνας	n-p---fa-	τέχνη	ᾱ
Τηρεΐας	v-pppafa-	Τηρεΐας	Ᾱ
τηρήσας	v-sapamn-	τηρέω	ᾱ
τιήρας	n-s---fg-	τιήρη	ᾱ
τιθήνας	n-s---fg-	τιθήνη	ᾱ
τιμᾶ	v2spma---	τιμᾶ	ᾱ
τιμᾶ	u--------	τιμᾶ	ᾱ
τιμᾶι	n-p---fn-	τιμᾶ	ᾱ
τιμᾶι	v3spia---	τιμᾶι	ᾱ
τιμᾶις	n-p---fd-	τιμᾶις	ᾱ
τιμαλφουμένας	v-pppefa-	τιμαλφουμένας	αᾱ
τιμᾶν	v--pna---	τιμᾶν	ᾱ
τιμάς	n-p---fa-	τιμάς	ᾱ
ἐτίμα	v3siia---	τιμάω	ᾱ
τιμᾷ	v3spia---	τιμάω	ᾱ
τίμα	v2spma---	τιμάω	ᾱ
τιμᾶν	v--pna---	τιμάω	ᾱ
τιμᾷς	n-p---fa-	τιμάω	ᾱ
τιμᾷς	v2spia---	τιμάω	ᾱ
τιμᾶσθαι	v--pne---	τιμάω	ᾱ
τιμᾶτε	v2ppma---	τιμάω	ᾱ
τιμήσας	v-sapamn-	τιμάω	ᾱ
τιμάς	n-p---fa-	τιμή	ᾱ
τιμάς	n-p---fa-	τιμή	ᾱ
τιμὰς	n-p---fa-	τιμή	ᾱ
τιμώσας	v-sapamn-	τιμόω	ᾱ
τινάς	a-p---fa-	τινάς	ᾱ
τινάξας	v-sapamn-	τινάσσω	αᾱ
τίνας	a-p---fa-	τίς	ᾱ
Τιτᾶνα	n-s---ma-	Τιτᾶν	Ᾱα
Τιτᾶνι	n-s---md-	Τιτᾶν	Ᾱ
Τιτᾶνας	n-p---ma-	Τιτᾶνης	Ᾱα
τίτας	n-p---fa-	τίτη	ᾱ
τλάς	a-p---fa-	τλάς	ᾱ
τλάς	a-s---mn-	τλάς	ᾱ
τλὰς	a-p---fa-	τλὰς	ᾱ
τλάσας	v-sapamn-	τλάσω	αᾱ
τλατᾶς	a-p---fa-	τλατᾶς	αᾱ
τοξότας	n-p---fa-	το	ᾱ
τοίας	a-p---fa-	τοῖος	ᾱ
τοιαύτας	a-p---fa-	τοιοῦτος	ᾱ
τόλμα	v2spma---	τόλμα	ᾱ
ἐτόλμα	v3siia---	τολμάω	ᾱ
ἐτόλμας	v2siia---	τολμάω	ᾱ
τολμήσας	v-sapamn-	τολμάω	ᾱ
τολμώσας	v-pppafa-	τολμάω	ᾱ
τολυπεύσας	v-sapamn-	τολυπεύσας	ᾱ
τομάς	n-p---fa-	τομά	ᾱ
τοξεύσας	v-sapamn-	τοξεύω	ᾱ
τοξοδάμας	n-s---mn-	τοξοδάμας	αᾱ
Τραχῖνι	n-s---fd-	τραχίς	Ῑι
τρέσας	v-sapamn-	τρέσας	ᾱ
τρέσας	v-sapamn-	τρέω	ᾱ
τριαίνας	n-p---fa-	τριαίνη	ᾱ
τριακάδας	n-p---fa-	τριακάς	ααᾱ
τριβᾶς	n-p---fa-	τριβᾶς	ᾱ
τριβᾷ	n-s---fd-	τριβή	ᾱ
τριβάς	n-p---fa-	τριβή	ᾱ
τριβὰς	n-p---fa-	τριβή	ᾱ
τριπλᾶ	a-p---na-	τριπλᾶ	ᾱ
τριπλᾶ	a-p---nn-	τριπλᾶ	ᾱ
τρισμυρίας	a-p---fa-	τρισμύριοι	ᾱ
Τρισσάς	a-p---fa-	Τρισσάς	Ᾱ
Τροζηνίας	n-p---fa-	Τροζηνία	Ᾱ
Τροζηνίας	n-s---fg-	Τροζηνία	Ᾱ
Τροζηνίας	n-p---fa-	Τροζηνίη	Ᾱ
Τροίας	n-s---fg-	τροία	Ᾱ
Τροΐας	n-s---fg-	Τροΐα	Ᾱ
Τροίας	n-s---fg-	Τροίας	Ᾱ
τροπάς	n-p---fa-	τροπή	ᾱ
τροπὰς	n-p---fa-	τροπή	ᾱ
τροφάς	n-p---fa-	τροφάς	ᾱ
τροφάς	n-p---fa-	τροφή	ᾱ
τροφάς	n-p---fa-	τροφή	ᾱ
τροφὰς	n-p---fa-	τροφή	ᾱ
τρυφᾶι	v3spia---	τρυφᾶι	ᾱ
τρυφᾶν	v--pna---	τρυφάω	ᾱ
τρυφάς	n-p---fa-	τρυφή	ᾱ
τρυφάς	n-p---fa-	τρυφή	ᾱ
τρυφὰς	n-p---fa-	τρυφή	ᾱ
Τρωιάς	a-p---fa-	Τρωιάς	Ᾱ
Τρωιάς	n-p---fa-	Τρωιάς	Ᾱ
Τρωιὰς	n-p---fa-	Τρωιὰς	Ᾱ
Τρωίας	a-p---fa-	Τρωίας	Ᾱ
Τρωϊκάς	a-p---fa-	Τρωϊκάς	Ᾱ
Τρωίας	a-p---fa-	Τρωῖος	Ᾱ
τυχούσας	v-sapafg-	τυγχάνω	ᾱ
Τυνδαρείας	a-s---fg-	Τυνδαρεία	Αᾱ
Τυρίας	n-p---fa-	Τυρίη	Ᾱ
τυφλάς	a-p---fa-	τυφλός	ᾱ
τυφλὰς	a-p---fa-	τυφλός	ᾱ
τυφλώσας	v-sapamn-	τυφλώσας	ᾱ
τύχᾳ	n-p---nn-	τύχᾳ	ᾱ
τύχαν	v2spma---	τύχαν	ᾱ
τύχα	n-s---mv-	τύχας	ᾱ
τύχας	n-p---fa-	τύχας	ᾱ
τυχαςἅ	n-s---fg-	τυχαςἅ	αᾱ
τυχάς	n-p---fa-	τυχή	ᾱ
τυχὰς	n-p---fa-	τυχή	ᾱ
τύχᾳ	n-s---fa-	τύχη	ᾱ
τύχᾳ	n-s---fn-	τύχη	ᾱ
τύχᾳ	n-s---fd-	τύχη	ᾱ
τύχας	n-p---fa-	τύχη	ᾱ
τύχας	n-s---fg-	τύχη	ᾱ
ὑγιείας	n-s---fg-	ὑγιεία	ᾱ
ὑγιείας	n-s---fg-	ὑγιείας	ᾱ
ὑγρᾶς	a-s---fg-	ὑγρός	ᾱ
ὕδρας	n-p---fa-	ὕδρα	ᾱ
ὕδρας	n-s---fg-	ὕδρα	ᾱ
ὑδρηλάς	n-p---fa-	ὑδρηλή	ᾱ
ὑδρηλὰς	n-p---fa-	ὑδρηλή	ᾱ
ὑλᾶντα	n-p---na-	ὑλᾶν	ᾱα
ὕλας	n-p---fa-	ὕλας	ᾱ
ὑλᾶεν	a-s---nn-	ὑλήεις	ᾱ
ὑμᾶς	u--------	ὑμᾶς	ᾱ
ὑμᾶς	p-p---ma-	ὑμεῖς	ᾱ
ὑμᾶς	p2p----a-	ὑμεῖς	ᾱ
ὑμᾶς	p-p----a-	ὑμεῖς	ᾱ
ὑμᾶς	p-p---fa-	ὑμεῖς	ᾱ
ὑμῖν	p-p----d-	ὑμεῖς	ῑ
ὑμῖν	p-p---md-	ὑμεῖς	ῑ
ὑμῖν	p2p----d-	ὑμεῖς	ῑ
ὑμετέρας	a-p---fa-	ὑμέτερος	ᾱ
ὑπαιθρίας	a-s---fg-	ὑπαιθρῖος	ᾱ
ὑπαλλαγάς	n-p---fa-	ὑπαλλαγή	ααᾱ
ὑπαλλαγὰς	n-p---fa-	ὑπαλλαγή	ααᾱ
ὑπαντήσας	v-sapamn-	ὑπαντήω	αᾱ
ὑπεκβᾶσ’	v-sapafn-	ὑπεκβᾶσ	ᾱ
ὑπεράρας	v-sapamn-	ὑπεραίρω	αᾱ
ὑπερβάς	v-sapamn-	ὑπερβαίνω	ᾱ
ὑπερβὰς	v-sapamn-	ὑπερβαίνω	ᾱ
ὑπερβαλλούσας	v-pppafa-	ὑπερβαλλούσας	αᾱ
ὑπερβολάς	n-p---fa-	ὑπερβολή	ᾱ
ὑπερποντίας	a-s---fg-	ὑπερποντίας	ᾱ
ὑπερτείνας	v-sapamn-	ὑπερτείνω	ᾱ
ὑπερτέρας	a-s---fg-	ὑπέρτερος	ᾱ
ὑπερφρονήσας	v-sapamn-	ὑπερφρονέω	ᾱ
ὑπνοδόταν	n-s---ma-	ὑπνοδότης	ᾱ
ὑποκάμψας	v-sapamn-	ὑποκάμπτω	αᾱ
ὑπόπταν	a-s---ma-	ὑπόπταν	ᾱ
ὑποπτήξας	v-sapamn-	ὑποπτήγω	ᾱ
ὑποπτήξας	v-sapamn-	ὑποπτήσσω	ᾱ
ὑποσπάσας	v-sapamn-	ὑποσπάω	αᾱ
ὑποστρέψας	v-sapamn-	ὑποστρέφω	ᾱ
ὑπουργίας	n-s---fg-	ὑπουργία	ᾱ
Ὑσιάς	n-p---fa-	ὑσιαί	Ᾱ
Ὑσταίχμας	n-s---mn-	Ὑσταίχμας	Ᾱ
ὑστάτας	a-p---fa-	ὑστάτας	αᾱ
ὑστέρας	a-p---fa-	ὕστερος	ᾱ
ὑφάς	n-p---fa-	ὑφή	ᾱ
ὑποστάς	v-sapamn-	ὑφίστημι	ᾱ
ὑποστὰς	v-sapamn-	ὑφίστημι	ᾱ
ὑποστήσας	v-sapamn-	ὑφίστημι	ᾱ
Φάμα	v2spma---	Φά	Αᾱ
φαεννάς	n-p---fa-	φαεν	αᾱ
φαεννὰς	n-p---fa-	φαεν	αᾱ
φαεννάς	a-p---fa-	φαεννάς	αᾱ
φαεννὰς	a-p---fa-	φαεννὰς	αᾱ
φαεννάς	a-p---fa-	φαεννός	αᾱ
φαεννὰς	a-p---fa-	φαεννός	αᾱ
Φαίδρας	n-s---fg-	Φαίδρας	Ᾱ
Φαίδρας	n-s---fg-	Φαίδρη	Ᾱ
φαμένας	v-sppefg-	φαμένας	αᾱ
φανάς	v-sapamn-	φανάς	αᾱ
φανὰς	v-sapamn-	φανὰς	αᾱ
φανείσας	v-sapafg-	φανείσας	αᾱ
Φαρσαλίας	a-p---fa-	Φαρσαλία	Ααᾱ
Φαρσαλίας	n-s---fg-	Φαρσαλία	Ααᾱ
φατίσας	v-sapamn-	φατίζω	αᾱ
φάτνας	n-p---fa-	φάτνη	αᾱ
φαυλοτέρας	a-s---fgc	φαυέρτλοος	ᾱ
Φεραίας	a-s---fg-	Φεραίη	Ᾱ
Φερητιάδας	n-s---mn-	Φερητιάδης	Αᾱ
φερνάς	n-p---fa-	φερνή	ᾱ
φερνάς	n-p---fa-	φερνή	ᾱ
φερνὰς	n-p---fa-	φερνή	ᾱ
φερνάς	a-p---fa-	φερνός	ᾱ
φερνὰς	a-p---fa-	φερνός	ᾱ
φερούσας	v-pppafa-	φερούσας	ᾱ
φερούσας	v-pppafa-	φέρω	ᾱ
φήμας	n-p---fa-	φήμη	ᾱ
φθάσας	v-sapamn-	φθάνω	αᾱ
Ἐφθαρμένας	v-prpefa-	φθείρω	Αᾱ
Φθιάς	n-p---fa-	Φθιά	Ᾱ
Φθιάς	n-s---fg-	Φθιὰ	Ᾱ
Φθιὰς	n-s---fg-	Φθιὰ	Ᾱ
Φθίας	n-s---fg-	Φθία	Ᾱ
Φθίας	n-p---fa-	Φθία	Ᾱ
φθιμένας	v-pppefa-	φθιμένας	ᾱ
φθίσας	v-sapamn-	φθίω	ᾱ
Φθιωτᾶν	n-s---fa-	Φθιωτᾶν	Ᾱ
Φθιωτίδας	n-s---fg-	Φθιωτίδα	Ᾱ
φθογγάς	n-p---fa-	φθογγή	ᾱ
φθογγάς	n-p---fa-	φθογγή	ᾱ
φθογγὰς	n-p---fa-	φθογγή	ᾱ
φθονήσας	v-sapamn-	φθονέω	ᾱ
φθοράς	n-p---fa-	φθορά	ᾱ
φθορὰς	n-p---fa-	φθορά	ᾱ
φιάλας	n-p---fa-	φιάλας	αᾱ
φίλᾳ	a-p---na-	φίλᾳ	ᾱ
φιλᾶν	a-s---fa-	φιλᾶν	ᾱ
φιλίας	n-p---fa-	φιλία	ᾱ
φιλίας	n-s---fg-	φιλία	ᾱ
φιλίας	n-s---fg-	φιλῖα	ᾱ
φίλας	a-s---fg-	φίλος	ᾱ
φίλας	a-p---fa-	φίλος	ᾱ
Φιλοτιμίας	n-s---fg-	φιλοτιμία	Ᾱ
Φινεΐδας	n-s---mn-	Φινεΐδαι	Ᾱ
φιτῦσαι	v--ana---	φιτῦζω	ῡ
φιτύσας	v-sapamn-	φιτύω	ᾱ
φλογεράν	a-s---ma-	φλογερὰς	ᾱ
φλογερὰν	a-s---ma-	φλογερὰς	ᾱ
φλογέας	a-p---fa-	φλογύς	ᾱ
φόβας	n-p---fa-	φόβη	ᾱ
Φοινίσσας	n-p---fa-	Φοῖνιξ	Ᾱ
φοινίας	a-s---fg-	φοίνιος	ᾱ
φοινίας	a-p---fa-	φοίνιος	ᾱ
φονεύσας	v-sapamn-	φονεύω	ᾱ
φονίᾳ	a-p---na-	φονῖος	ᾱ
φονίας	n-p---fa-	φονῖος	ᾱ
φονίας	a-s---fg-	φονῖος	ᾱ
φονίας	a-p---fa-	φονῖος	ᾱ
φορβάν	v2spma---	φορβάν	ᾱ
φορβὰν	v2spma---	φορβὰν	ᾱ
φορβάν	n-s---ma-	φορβή	ᾱ
φορβὰν	n-s---ma-	φορβή	ᾱ
Φόρβας	n-p---fa-	Φόρβη	Ᾱ
φράσας	v-sapamn-	φράζω	αᾱ
φράσας	v-sapamn-	φράσας	αᾱ
φρένας	n-p---fa-	φρένας	ᾱ
φρένας	n-p---fa-	φρήν	ᾱ
φρίξας	v-sapamn-	φρίζω	ᾱ
φρονήσας	v-sapamn-	φρονέω	ᾱ
φροντίσας	v-sapamn-	φροντίζω	ᾱ
φροντίδας	n-p---fa-	φροντίς	ᾱ
φρουρήσας	v-sapamn-	φρουρέω	ᾱ
Φρυγίας	n-s---fg-	Φρυγία	Ᾱ
φρυκτωρίας	n-s---fg-	φρυκτωρία	ᾱ
φυγᾶς	n-s---fg-	φυγᾶ	ᾱ
φυγᾷ	u--------	φυγᾷ	ᾱ
φυγᾷ	d--------	φυγᾷ	ᾱ
φυγᾷ	n-s---fa-	φυγᾷ	ᾱ
φυγᾶι	n-p---fn-	φυγᾶι	ᾱ
φυγάδας	n-p---fa-	φυγάς	αᾱ
φυγάς	n-p---fa-	φυγάς	ᾱ
φυγᾶι	n-p---fn-	φυγᾶς	ᾱ
φυγᾶς	n-p---fa-	φυγᾶς	ᾱ
φυγᾷ	n-s---ma-	φυγᾷς	ᾱ
φυγάς	n-p---fa-	φυγή	ᾱ
φυγάς	n-s---mn-	φυγή	ᾱ
φυγάς	n-s---fg-	φυγή	ᾱ
φυγὰς	n-p---fa-	φυγή	ᾱ
φυγὰς	n-s---mn-	φυγή	ᾱ
φυγὰς	n-s---fg-	φυγή	ᾱ
φυγᾶς	n-s---fg-	φυγή	ᾱ
φυγούσας	v-pppafa-	φυγούσας	ᾱ
φυλακᾷ	n-s---ma-	φυλακᾷ	αᾱ
φυλακᾶς	n-p---fa-	φυλακᾶς	αᾱ
φυλακάς	n-p---fa-	φυλακή	αᾱ
φυλακάς	n-p---fa-	φυλακή	αᾱ
φυλακὰς	n-p---fa-	φυλακή	αᾱ
φυλάξας	v-sapamn-	φυλάσσω	αᾱ
φυλλάς	n-s---fg-	φυλλὰ	ᾱ
φυλλὰς	n-s---fg-	φυλλὰ	ᾱ
φυξανορίᾳ	n-s---ma-	φυξανορίᾳ	αᾱ
φύσας	n-p---fa-	φῦσα	ᾱ
φυσᾶις	v2sfia---	φυσᾶις	ᾱ
φύσας	v-sapamn-	φύσας	ᾱ
φυσιᾷ	n-s---fa-	φυσιάω	ᾱ
φυτεύσας	v-sapamn-	φυτεύω	ᾱ
φύσας	v-sapamn-	φύω	ᾱ
φωνάς	n-p---fa-	φωνή	ᾱ
φωνὰς	n-p---fa-	φωνή	ᾱ
χαίτας	n-p---fa-	χαί	ᾱ
χαίτας	n-p---fa-	χαίτη	ᾱ
χάλα	v2spma---	χάλα	αᾱ
χαλάσας	v-sapamn-	χαλάζω	ααᾱ
χαλᾶι	v3spia---	χαλᾶι	αᾱ
χαλᾶι	n-s---fd-	χαλᾶι	αᾱ
χαλᾶτε	v2ppma---	χαλᾶτε	αᾱ
χαλᾷ	v3spia---	χαλάω	αᾱ
χαλᾶν	v--pna---	χαλάω	αᾱ
χαλᾷς	v2spia---	χαλάω	αᾱ
χαλᾶτε	v2ppma---	χαλάω	αᾱ
Χαλᾶτε	v2ppma---	χαλάω	Αᾱ
Χαλᾶν	v--pna---	Χαλάω	Αᾱ
χαλεπᾶι	a-p---fn-	χαλεπᾶι	αᾱ
χαλεπᾶς	a-p---fa-	χαλεπός	αᾱ
χαλκέας	a-p---fa-	χαλκής	αᾱ
χαλκοβόαν	n-s---ma-	χαλκοβόας	αᾱ
χαμᾶζε	d--------	χαμᾶζε	αᾱ
χαμεύνας	n-p---fa-	χαμεύ	αᾱ
χαμεύνας	n-p---fa-	χαμεύνη	αᾱ
χαρᾷ	n-s---fd-	χαρά	αᾱ
χαρᾶς	n-s---fg-	χαρά	αᾱ
χαρᾶι	n-p---fn-	χαρᾶ	αᾱ
χαρᾶι	n-p---fd-	χαρᾶ	αᾱ
χαρᾶι	n-s---nd-	χαρᾶ	αᾱ
χαρᾶι	n-s---fd-	χαρᾶι	αᾱ
χαρμονᾶν	n-s---fa-	χαρμονᾶν	αᾱ
χαρμονάς	n-p---fa-	χαρμονάς	αᾱ
χἀρπαγάς	n-p---fa-	χἀρπαγή	ααᾱ
χἀρπαγὰς	n-p---fa-	χἀρπαγή	ααᾱ
χἀτέρᾳ	a-p---nac	χἀτέρᾳ	αᾱ
χέρας	n-p---fa-	χείρ	ᾱ
χειρωναξίας	n-p---fa-	χειρωναξίας	αᾱ
χεούσας	v-pppafa-	χεούσας	ᾱ
χέρας	n-p---fa-	χέρας	ᾱ
χερμάδας	n-p---fa-	χερμάς	αᾱ
χεροτεκτοσύνας	n-p---fa-	χεροτεκτοσύνη	ᾱ
χηλάς	n-p---fa-	χηλή	ᾱ
χηλὰς	n-p---fa-	χηλή	ᾱ
χθονίας	a-s---fg-	χθονῖος	ᾱ
Χθονίας	a-p---fa-	Χθονῖος	Ᾱ
χιλιάς	a-p---fa-	χιλιάς	ᾱ
χιλιὰς	a-p---fa-	χιλιὰς	ᾱ
χιλιοναύταν	n-s---ma-	χιλιοναύτης	ᾱ
χιμαίρας	n-p---fa-	χιμαίρη	ᾱ
χλιδάς	n-p---fa-	χλιδά	ᾱ
χλιδᾶν	n-s---fa-	χλιδᾶ	ᾱ
χλιδᾶς	n-s---fg-	χλιδᾶ	ᾱ
χλιδᾷ	n-s---fn-	χλιδᾷ	ᾱ
χλιδᾷς	v2spia---	χλιδάω	ᾱ
χνας	n-p---fa-	χνη	ᾱ
χνόας	n-p---fa-	χνόας	ᾱ
χνόας	n-p---fa-	χνόη	ᾱ
χοάς	n-p---fa-	χοάς	ᾱ
χοάς	n-p---fa-	χοή	ᾱ
χοάς	n-p---fa-	χοή	ᾱ
Χοάς	n-p---fa-	χοή	Ᾱ
χοὰς	n-p---fa-	χοή	ᾱ
Χοὰς	n-p---fa-	χοή	Ᾱ
χορεύσας	v-sapamn-	χορεύω	ᾱ
χἀτέρας	a-p---fa-	χότερἀς	αᾱ
χρείας	n-p---fa-	χρεία	ᾱ
χρείας	n-s---fg-	χρεία	ᾱ
χρείας	n-s---fg-	χρείας	ᾱ
χρήσας	v-sapamn-	χρήδω	ᾱ
χρηστάς	a-p---fa-	χρηστός	ᾱ
χρηστὰς	a-p---fa-	χρηστός	ᾱ
χρήσας	v-sapamn-	χρήω	ᾱ
χρονίᾳ	a-p---na-	χρονία	ᾱ
χρονίας	a-p---fa-	χρονίας	ᾱ
χρυσέας	a-s---fg-	χρύσεος	ᾱ
χρυσέας	a-p---fa-	χρύσεος	ᾱ
χρυσοκόμας	a-s---mn-	χρυσοκόμας	ᾱ
χρυσομίτραν	n-s---ma-	χρυσομίτρας	ᾱ
χὐμῖν	n-s---fn-	χὐμῖα	ῑ
χώρας	n-s---fg-	χώρα	ᾱ
Χώρας	n-s---fg-	χώρα	Ᾱ
χωρίσας	v-sapamn-	χωρίζω	ᾱ
ψαμμίας	n-p---fa-	ψαμμία	αᾱ
ψαύσας	v-sapamn-	ψαύω	ᾱ
ψαφαρᾷ	n-s---fa-	ψαφαρᾷ	ααᾱ
ψεύσας	v-sapamn-	ψεύω	ᾱ
ψυχᾶι	n-p---fn-	ψυχᾶ	ᾱ
ψυχᾶι	n-p---fv-	ψυχᾶ	ᾱ
ψυχᾶι	n-p---fn-	ψυχᾶι	ᾱ
ψυχᾶς	u--------	ψυχᾶς	ᾱ
ψυχᾷ	n-s---fd-	ψυχή	ᾱ
ψυχάς	n-p---fa-	ψυχή	ᾱ
ψυχὰς	n-p---fa-	ψυχή	ᾱ
ψυχᾶς	n-p---fa-	ψυχή	ᾱ
ψυχᾶς	n-s---fg-	ψυχή	ᾱ
ᾠδάς	n-p---fa-	ᾠδάς	ᾱ
ὠιδάς	n-p---fa-	ὠιδάς	ᾱ
ὠιδάς	n-p---fa-	ὠιδάς	ᾱ
ὠιδὰς	n-p---fa-	ὠιδὰς	ᾱ
ὠινωμένας	v-prpefa-	ὠινωμένας	ᾱ
ὠκιστᾶν	v3paia---	ὠκιστᾶν	ᾱ
ὠκυπέτᾳ	a-p---na-	ὠκυπέτᾳ	ᾱ
ὠλένας	n-p---fa-	ὠλένη	ᾱ
ὥρας	n-p---fa-	ὥρα	ᾱ
ὥρας	n-s---fg-	ὥρα	ᾱ
ὠφελήσας	v-sapamn-	ὠφελάω	ᾱ
